AAACCTGAGACTGGGT-1	unclassified
AAACGGGTCCATTCTA-1	unclassified
AAAGATGGTCCGAAGA-1	unclassified
AAAGCAATCTACCAGA-1	unclassified
AACGTTGCATAAAGGT-1	unclassified
AACTCCCCAGGTTTCA-1	unclassified
AACTTTCAGAGCCCAA-1	unclassified
AACTTTCCACCAGTTA-1	unclassified
AACTTTCGTTGAACTC-1	unclassified
AAGACCTTCACCACCT-1	unclassified
AAGGAGCCACTGTGTA-1	unclassified
AAGGCAGAGGTAAACT-1	unclassified
AAGGCAGGTGTTCTTT-1	unclassified
AAGTCTGAGTGGGATC-1	unclassified
AATCCAGGTTGTCTTT-1	unclassified
AATCGGTTCACGAAGG-1	unclassified
ACACCAATCACGCGGT-1	unclassified
ACAGCCGTCTGCTGCT-1	unclassified
ACAGCTAAGTACACCT-1	unclassified
ACAGCTACAGTATCTG-1	unclassified
ACCAGTACAAAGTCAA-1	unclassified
ACCCACTGTAAGTGTA-1	unclassified
ACGAGCCAGGCATGTG-1	unclassified
ACGCAGCCAACTGGCC-1	unclassified
ACGCCAGCAACGCACC-1	unclassified
ACGGAGAAGCCACTAT-1	unclassified
ACGGGCTGTTGGTAAA-1	unclassified
ACTGAGTAGATGTTAG-1	unclassified
ACTGATGAGTGGGCTA-1	unclassified
ACTGATGCAAAGTGCG-1	unclassified
ACTTACTCAATACGCT-1	unclassified
ACTTACTTCTAACTTC-1	unclassified
ACTTGTTCACTCGACG-1	unclassified
ACTTTCAAGAACTCGG-1	unclassified
ACTTTCATCTCTAAGG-1	unclassified
AGACGTTGTTCGTTGA-1	unclassified
AGAGTGGTCAGCTTAG-1	unclassified
AGATTGCTCGCCATAA-1	unclassified
AGCGGTCCACCTCGTT-1	unclassified
AGCTCTCTCCGATATG-1	unclassified
AGGCCGTAGTGTACTC-1	unclassified
AGGCCGTTCTCCCTGA-1	unclassified
AGGTCCGGTTCGAATC-1	unclassified
AGTCTTTCATTGGCGC-1	unclassified
AGTGGGACACATGTGT-1	unclassified
ATAACGCCATCGTCGG-1	unclassified
ATAACGCTCGGCATCG-1	unclassified
ATCATGGAGGATTCGG-1	unclassified
ATCATGGGTAGGGTAC-1	unclassified
ATCCGAAAGCGATGAC-1	unclassified
ATCCGAAGTCGGCTCA-1	unclassified
ATCTGCCAGAGTAATC-1	unclassified
ATGAGGGCATTGGGCC-1	unclassified
ATGAGGGGTCTAGTCA-1	unclassified
ATGGGAGCATGTAGTC-1	unclassified
ATTATCCCATGCAACT-1	unclassified
ATTGGACGTCTCATCC-1	unclassified
ATTGGTGTCTTGACGA-1	unclassified
ATTTCTGTCTATCGCC-1	unclassified
CAACCAAAGACCTAGG-1	unclassified
CAACCAACAGTCTTCC-1	unclassified
CAACCAAGTTATGTGC-1	unclassified
CAACCTCCACAGTCGC-1	unclassified
CAACCTCTCATGTAGC-1	unclassified
CAAGATCCATCGGTTA-1	unclassified
CAAGATCCATGCGCAC-1	unclassified
CAAGATCTCAGCGATT-1	unclassified
CAAGTTGGTTGGTGGA-1	unclassified
CACACAACAATCTACG-1	unclassified
CACAGTATCAACGGGA-1	unclassified
CACAGTATCTCATTCA-1	unclassified
CACATTTAGGTGTGGT-1	unclassified
CACCTTGAGGTTCCTA-1	unclassified
CAGAATCAGTGGTAAT-1	unclassified
CAGATCAGTTTGGGCC-1	unclassified
CAGTAACAGGCAAAGA-1	unclassified
CAGTCCTTCCAAGTAC-1	unclassified
CATATGGAGTGAATTG-1	unclassified
CATCAGAAGGTGTGGT-1	unclassified
CATCAGAAGTGCGATG-1	unclassified
CATCAGAGTCCGACGT-1	unclassified
CATCAGAGTCGGCATC-1	unclassified
CATCCACCACATCCGG-1	unclassified
CATCCACCAGCTGTGC-1	unclassified
CATGACAGTGATGTCT-1	unclassified
CCACCTATCGATCCCT-1	unclassified
CCAGCGATCCGAGCCA-1	unclassified
CCATGTCAGTCCGGTC-1	unclassified
CCATGTCCACTGCCAG-1	unclassified
CCCAGTTCATACAGCT-1	unclassified
CCCTCCTGTGCTCTTC-1	unclassified
CCCTCCTGTTACTGAC-1	unclassified
CCGTACTAGAGTTGGC-1	unclassified
CCGTACTGTCGCGAAA-1	unclassified
CCGTGGAGTATAAACG-1	unclassified
CCTAAAGTCCGTCATC-1	unclassified
CCTACACTCCGTAGTA-1	unclassified
CCTATTAGTACATCCA-1	unclassified
CCTCTGATCGCTTGTC-1	unclassified
CCTTACGTCTTCATGT-1	unclassified
CCTTCCCAGGGATCTG-1	unclassified
CCTTCCCTCGTTGACA-1	unclassified
CCTTTCTAGGCACATG-1	unclassified
CCTTTCTCAGGCGATA-1	unclassified
CCTTTCTGTACTTGAC-1	unclassified
CGACTTCAGGTGACCA-1	unclassified
CGAGCCAGTGTGGTTT-1	unclassified
CGATGGCTCCAAACTG-1	unclassified
CGCCAAGGTCGCTTTC-1	unclassified
CGCGTTTGTATATGAG-1	unclassified
CGCGTTTGTCCGAATT-1	unclassified
CGCTATCTCCGCATCT-1	unclassified
CGCTGGAAGTTCGCGC-1	unclassified
CGCTTCAGTCGCGAAA-1	unclassified
CGGACACTCGAGGTAG-1	unclassified
CGGACGTAGCGAGAAA-1	unclassified
CGGACGTTCACAGTAC-1	unclassified
CGGAGTCAGCTATGCT-1	unclassified
CGGCTAGTCGCCGTGA-1	unclassified
CGGTTAAAGTGTTAGA-1	unclassified
CGTAGCGCACCCAGTG-1	unclassified
CGTCAGGTCAACGCTA-1	unclassified
CGTCCATGTCCGAACC-1	unclassified
CGTGAGCAGATCCGAG-1	unclassified
CGTGTCTAGATGTGGC-1	unclassified
CGTGTCTCATTTGCCC-1	unclassified
CTAAGACAGGCCCGTT-1	unclassified
CTAAGACTCCAAATGC-1	unclassified
CTAATGGAGTTTAGGA-1	unclassified
CTACACCAGCTAACAA-1	unclassified
CTACATTAGATAGTCA-1	unclassified
CTACATTAGTGCGATG-1	unclassified
CTACGTCCAATGGACG-1	unclassified
CTAGTGAAGATATACG-1	unclassified
CTAGTGAGTTAGTGGG-1	unclassified
CTCACACAGAGACTTA-1	unclassified
CTCAGAACATGTCTCC-1	unclassified
CTCATTAGTCACTGGC-1	unclassified
CTCATTATCAGGCGAA-1	unclassified
CTCGAAAGTAGCTAAA-1	unclassified
CTCGAGGGTGATGATA-1	unclassified
CTCGGAGTCCACGAAT-1	unclassified
CTCGGGATCTTAACCT-1	unclassified
CTCGTCAGTGCCTGTG-1	unclassified
CTCTACGGTAAATGAC-1	unclassified
CTCTGGTTCGTTTAGG-1	unclassified
CTGAAACGTTGTCTTT-1	unclassified
CTGAAGTGTCACAAGG-1	unclassified
CTGCCTAAGGACATTA-1	unclassified
CTGTTTACACAACTGT-1	unclassified
CTGTTTATCCTTCAAT-1	unclassified
CTTAACTTCGTGGGAA-1	unclassified
CTTACCGTCGCATGGC-1	unclassified
CTTGGCTGTGAAATCA-1	unclassified
CTTGGCTTCCTACAGA-1	unclassified
CTTGGCTTCTGCTGCT-1	unclassified
CTTTGCGGTGATGCCC-1	unclassified
GAAATGAGTCTGCCAG-1	unclassified
GAACATCAGGCAATTA-1	unclassified
GAAGCAGAGTGACATA-1	unclassified
GAATGAACAAGTACCT-1	unclassified
GAATGAACATCTACGA-1	unclassified
GACACGCAGACGCAAC-1	unclassified
GACACGCGTTAAGGGC-1	unclassified
GACCAATTCATGTCTT-1	unclassified
GACCAATTCCTGCCAT-1	unclassified
GACCAATTCTAGAGTC-1	unclassified
GACGCGTAGGGTGTTG-1	unclassified
GACGCGTTCACATGCA-1	unclassified
GACGGCTAGCGTAATA-1	unclassified
GACTGCGAGAAACCTA-1	unclassified
GACTGCGAGTATTGGA-1	unclassified
GACTGCGAGTCATGCT-1	unclassified
GAGCAGAAGGAATGGA-1	unclassified
GATCGATCATTACCTT-1	unclassified
GATCGATGTCTAGTCA-1	unclassified
GATCTAGTCATAAAGG-1	unclassified
GATGAAAAGTGTGAAT-1	unclassified
GATGAAACAGGGATTG-1	unclassified
GCACTCTGTTCAGCGC-1	unclassified
GCAGCCAAGAAACCGC-1	unclassified
GCAGCCAGTGTTTGTG-1	unclassified
GCATACACAAATTGCC-1	unclassified
GCATGATAGCTGCCCA-1	unclassified
GCATGATCAATCGGTT-1	unclassified
GCATGTAAGGACGAAA-1	unclassified
GCATGTACAACCGCCA-1	unclassified
GCATGTACACCAGGCT-1	unclassified
GCCTCTATCTAGCACA-1	unclassified
GCGACCACAGATGGGT-1	unclassified
GCGACCATCCTGCCAT-1	unclassified
GCGCAGTCATGCCTTC-1	unclassified
GCTCCTACACGCATCG-1	unclassified
GCTCCTATCAATAAGG-1	unclassified
GCTGCAGTCCCATTTA-1	unclassified
GCTGCGAAGAGTCTGG-1	unclassified
GCTGCGATCTGTCAAG-1	unclassified
GCTGCTTGTCGCTTTC-1	unclassified
GCTGCTTTCATGCAAC-1	unclassified
GCTGGGTAGACCACGA-1	unclassified
GCTTCCACAAGCTGTT-1	unclassified
GCTTGAACAATCCGAT-1	unclassified
GCTTGAACACTTAACG-1	unclassified
GGAACTTAGTAGCGGT-1	unclassified
GGACAGATCGGCATCG-1	unclassified
GGAGCAAGTAGCGTCC-1	unclassified
GGGACCTCAGCCTTGG-1	unclassified
GGGATGAGTGATAAAC-1	unclassified
GGGATGATCAAGGTAA-1	unclassified
GGGCACTTCGGAGCAA-1	unclassified
GGGTCTGAGGCATGGT-1	unclassified
GGTGAAGTCATAAAGG-1	unclassified
GGTGCGTGTCAGAAGC-1	unclassified
GGTGCGTGTCCGAAGA-1	unclassified
GGTGTTAAGCTTATCG-1	unclassified
GTAACGTTCTTTAGTC-1	unclassified
GTAACTGCAGATGAGC-1	unclassified
GTAGTCACAGGACCCT-1	unclassified
GTAGTCATCATCGATG-1	unclassified
GTCACGGTCAGAGCTT-1	unclassified
GTCCTCAAGTACGTAA-1	unclassified
GTCGGGTTCTTTAGGG-1	unclassified
GTCTTCGAGCTAGGCA-1	unclassified
GTCTTCGCACCGATAT-1	unclassified
GTGAAGGGTTGCGCAC-1	unclassified
GTGAAGGTCATGCTCC-1	unclassified
GTGCAGCGTAGCGTCC-1	unclassified
GTGGGTCCAAGCCATT-1	unclassified
GTGGGTCCACTCTGTC-1	unclassified
GTGGGTCTCAATCTCT-1	unclassified
GTGGGTCTCACGCGGT-1	unclassified
GTGGGTCTCGTCACGG-1	unclassified
GTGTGCGCAAGTCTAC-1	unclassified
GTTAAGCAGTCTCCTC-1	unclassified
GTTAAGCTCAATAAGG-1	unclassified
GTTACAGAGACTTTCG-1	unclassified
GTTCATTCAGCAGTTT-1	unclassified
GTTCATTGTTGGTGGA-1	unclassified
GTTTCTAGTTAGAACA-1	unclassified
TAAACCGCACGGTGTC-1	unclassified
TAAGTGCCAAATCCGT-1	unclassified
TACACGAGTGCATCTA-1	unclassified
TACGGATAGTGGACGT-1	unclassified
TACGGGCCATGGTAGG-1	unclassified
TACGGTATCCTTGGTC-1	unclassified
TACTCATAGGCATTGG-1	unclassified
TACTCGCTCTTATCTG-1	unclassified
TAGGCATGTACTCTCC-1	unclassified
TAGGCATTCTACTTAC-1	unclassified
TAGTTGGAGGAGTAGA-1	unclassified
TAGTTGGCATATGCTG-1	unclassified
TCACAAGAGTGCTGCC-1	unclassified
TCACGAACAGACAAAT-1	unclassified
TCAGGATTCGAATCCA-1	unclassified
TCCACACTCGTCCGTT-1	unclassified
TCGAGGCCATGCTAGT-1	unclassified
TCGAGGCTCGTGGACC-1	unclassified
TCGCGAGCACTTAACG-1	unclassified
TCGGTAAAGTCGCCGT-1	unclassified
TCTATTGAGACCCACC-1	unclassified
TCTATTGGTCATTAGC-1	unclassified
TCTGAGATCGTATCAG-1	unclassified
TCTTCGGTCTCCAACC-1	unclassified
TGACTTTAGGGCATGT-1	unclassified
TGATTTCCAGGTGGAT-1	unclassified
TGCACCTTCGTTGCCT-1	unclassified
TGCCCATAGATAGCAT-1	unclassified
TGCGCAGCAGAGTGTG-1	unclassified
TGCGTGGCAAGTTGTC-1	unclassified
TGGACGCGTTCCGGCA-1	unclassified
TGGCCAGCACGGTTTA-1	unclassified
TGGCGCATCCGCAGTG-1	unclassified
TGGCTGGAGTCAATAG-1	unclassified
TGGGAAGAGACGACGT-1	unclassified
TGGGAAGCATGCAACT-1	unclassified
TGGGCGTTCGGATGGA-1	unclassified
TGGTTAGGTTCTGGTA-1	unclassified
TGGTTCCAGTCAAGGC-1	unclassified
TGTATTCGTACCGCTG-1	unclassified
TGTCCCATCATGCTCC-1	unclassified
TGTGGTACACATGACT-1	unclassified
TGTGGTACATGCTGGC-1	unclassified
TGTTCCGAGCTATGCT-1	unclassified
TGTTCCGCAGCATACT-1	unclassified
TTAACTCGTAAACGCG-1	unclassified
TTCTACAAGACTAGAT-1	unclassified
TTCTACAAGTATGACA-1	unclassified
TTCTCAAGTGTGCCTG-1	unclassified
TTCTCCTCAACTGGCC-1	unclassified
TTCTCCTCAAGACGTG-1	unclassified
TTCTCCTTCGTTTGCC-1	unclassified
TTGAACGGTATTAGCC-1	unclassified
TTGGAACGTCCAAGTT-1	unclassified
TTGGAACGTTACAGAA-1	unclassified
TTTATGCCAAGTTAAG-1	unclassified
TTTGCGCCATCTATGG-1	unclassified
TTTGCGCGTTACAGAA-1	unclassified
TTTGGTTTCGGCCGAT-1	unclassified
TTTGTCAGTAAGGGAA-1	unclassified
TTTGTCATCCAGAGGA-1	unclassified
AAACCTGAGAGCCTAG-1	Enterocyte
AAACCTGAGTCAAGCG-1	Enterocyte
AAACCTGAGTTGAGTA-1	Enterocyte
AAACCTGCAGCTGTAT-1	Enterocyte
AAACCTGGTTGGGACA-1	Enterocyte
AAACGGGAGATGGCGT-1	Enterocyte
AAAGATGCAGACAGGT-1	Enterocyte
AAAGCAATCGGCGGTT-1	Enterocyte
AAAGCAATCGTCGTTC-1	Enterocyte
AAAGTAGAGTGCGATG-1	Enterocyte
AAATGCCCAGGTCCAC-1	Enterocyte
AAATGCCTCTCGATGA-1	Enterocyte
AACACGTTCCTCTAGC-1	Enterocyte
AACCATGCAGAGCCAA-1	Enterocyte
AACCATGTCCGAACGC-1	Enterocyte
AACCGCGAGCGGATCA-1	Enterocyte
AACCGCGAGGACACCA-1	Enterocyte
AACGTTGAGACAGAGA-1	Enterocyte
AACGTTGAGAGACGAA-1	Enterocyte
AACGTTGCAAACGCGA-1	Enterocyte
AACTCAGAGCCTATGT-1	Enterocyte
AACTCAGCAGCTCGCA-1	Enterocyte
AACTCAGCATATACGC-1	Enterocyte
AACTCAGGTCGCTTCT-1	Enterocyte
AACTCAGGTGTGGCTC-1	Enterocyte
AACTCAGTCACGATGT-1	Enterocyte
AACTCCCAGGGCTCTC-1	Enterocyte
AACTCCCGTCTAGTCA-1	Enterocyte
AACTCTTCAAGAGGCT-1	Enterocyte
AACTGGTGTTCAGTAC-1	Enterocyte
AACTGGTTCCTAAGTG-1	Enterocyte
AACTTTCAGCTCCTCT-1	Enterocyte
AAGACCTAGAAACGCC-1	Enterocyte
AAGACCTAGATGTAAC-1	Enterocyte
AAGCCGCCAAGTTGTC-1	Enterocyte
AAGGAGCAGGTCGGAT-1	Enterocyte
AAGGAGCGTAGAAAGG-1	Enterocyte
AAGGAGCTCCAGTATG-1	Enterocyte
AAGGCAGCACCGAAAG-1	Enterocyte
AAGGCAGCACCGATAT-1	Enterocyte
AAGGCAGCAGGATCGA-1	Enterocyte
AAGGCAGCATGTAGTC-1	Enterocyte
AAGGCAGGTCTCCCTA-1	Enterocyte
AAGGCAGTCTGCTGCT-1	Enterocyte
AAGGTTCCACATCCAA-1	Enterocyte
AAGGTTCCAGTATCTG-1	Enterocyte
AAGTCTGCACGAAATA-1	Enterocyte
AAGTCTGCAGTATCTG-1	Enterocyte
AAGTCTGTCGAATGGG-1	Enterocyte
AATCCAGAGCTAACAA-1	Enterocyte
AATCCAGGTCACTTCC-1	Enterocyte
AATCGGTCAACTGCTA-1	Enterocyte
ACACCAAAGGGATACC-1	Enterocyte
ACACCAAGTCATGCAT-1	Enterocyte
ACACCCTAGCGATAGC-1	Enterocyte
ACACCCTCACGCGAAA-1	Enterocyte
ACACCGGAGGCCCTCA-1	Enterocyte
ACACCGGGTGACTCAT-1	Enterocyte
ACACTGACAATGGACG-1	Enterocyte
ACACTGATCTACGAGT-1	Enterocyte
ACACTGATCTGATACG-1	Enterocyte
ACAGCCGAGAGGTACC-1	Enterocyte
ACAGCCGTCCGGGTGT-1	Enterocyte
ACAGCTAGTAACGCGA-1	Enterocyte
ACAGCTAGTAGTACCT-1	Enterocyte
ACATACGAGATAGCAT-1	Enterocyte
ACATACGCATGTTGAC-1	Enterocyte
ACATCAGCAGACAAGC-1	Enterocyte
ACATCAGGTGACTACT-1	Enterocyte
ACATCAGTCGCCTGAG-1	Enterocyte
ACATGGTCAAAGAATC-1	Enterocyte
ACATGGTCATGTCGAT-1	Enterocyte
ACATGGTTCGCGTTTC-1	Enterocyte
ACCAGTAAGGTGACCA-1	Enterocyte
ACCAGTATCATCACCC-1	Enterocyte
ACCCACTAGTGATCGG-1	Enterocyte
ACCCACTAGTGCAAGC-1	Enterocyte
ACCCACTCAACGATGG-1	Enterocyte
ACCCACTGTCTAAACC-1	Enterocyte
ACCGTAAAGCAGGTCA-1	Enterocyte
ACCGTAAGTCCGACGT-1	Enterocyte
ACCGTAAGTCTACCTC-1	Enterocyte
ACCGTAATCAGATAAG-1	Enterocyte
ACCGTAATCCTATGTT-1	Enterocyte
ACCGTAATCGCCAAAT-1	Enterocyte
ACCTTTAAGCACCGCT-1	Enterocyte
ACGAGCCGTTATGCGT-1	Enterocyte
ACGAGGAAGTGGGATC-1	Enterocyte
ACGAGGATCAGGATCT-1	Enterocyte
ACGATACCATAGAAAC-1	Enterocyte
ACGATGTCAATCGGTT-1	Enterocyte
ACGATGTGTATTAGCC-1	Enterocyte
ACGCAGCCACAACTGT-1	Enterocyte
ACGCAGCCAGTAGAGC-1	Enterocyte
ACGCCAGAGAAACCGC-1	Enterocyte
ACGCCAGAGACGCACA-1	Enterocyte
ACGCCGAAGGGCACTA-1	Enterocyte
ACGCCGACATGGGACA-1	Enterocyte
ACGCCGATCTCACATT-1	Enterocyte
ACGGAGAGTGGAAAGA-1	Enterocyte
ACGGAGATCCCAACGG-1	Enterocyte
ACGGAGATCGTCACGG-1	Enterocyte
ACGGGTCAGGAGCGTT-1	Enterocyte
ACGGGTCAGTCCGGTC-1	Enterocyte
ACGGGTCTCACAAACC-1	Enterocyte
ACGTCAAGTCATCCCT-1	Enterocyte
ACGTCAATCGCAAGCC-1	Enterocyte
ACGTCAATCTATGTGG-1	Enterocyte
ACTATCTCAGTTCCCT-1	Enterocyte
ACTATCTGTTCTGGTA-1	Enterocyte
ACTGAACCAGGGCATA-1	Enterocyte
ACTGAACTCAGCTGGC-1	Enterocyte
ACTGAACTCAGGTAAA-1	Enterocyte
ACTGAGTAGCGATGAC-1	Enterocyte
ACTGATGAGCACCGCT-1	Enterocyte
ACTGATGAGTCCGGTC-1	Enterocyte
ACTGATGCAATGAATG-1	Enterocyte
ACTGATGCACTGTCGG-1	Enterocyte
ACTGATGCACTTCGAA-1	Enterocyte
ACTGATGGTTGAACTC-1	Enterocyte
ACTGCTCAGTGTACCT-1	Enterocyte
ACTGCTCCACCCAGTG-1	Enterocyte
ACTGCTCTCATGCAAC-1	Enterocyte
ACTGTCCCAAGTCTAC-1	Enterocyte
ACTGTCCCATCCGCGA-1	Enterocyte
ACTGTCCTCGCATGAT-1	Enterocyte
ACTTACTAGACTTGAA-1	Enterocyte
ACTTACTAGTATGACA-1	Enterocyte
ACTTGTTTCAAACCGT-1	Enterocyte
ACTTGTTTCAGCATGT-1	Enterocyte
ACTTTCACACATTCGA-1	Enterocyte
ACTTTCAGTAGAAGGA-1	Enterocyte
ACTTTCATCCCAAGTA-1	Enterocyte
AGAATAGAGAGCTGGT-1	Enterocyte
AGAATAGAGGACAGAA-1	Enterocyte
AGAATAGCAAAGGAAG-1	Enterocyte
AGAATAGTCGTACCGG-1	Enterocyte
AGAATAGTCGTCGTTC-1	Enterocyte
AGAATAGTCTTCTGGC-1	Enterocyte
AGACGTTAGATGTCGG-1	Enterocyte
AGACGTTGTGTGACGA-1	Enterocyte
AGAGCGAAGAGTCGGT-1	Enterocyte
AGAGCGAAGCCCAGCT-1	Enterocyte
AGAGCGACAGCTATTG-1	Enterocyte
AGAGCGAGTATCACCA-1	Enterocyte
AGAGCGAGTCTCATCC-1	Enterocyte
AGAGCTTAGAACTGTA-1	Enterocyte
AGAGCTTTCTAACTGG-1	Enterocyte
AGAGTGGCAATGGACG-1	Enterocyte
AGAGTGGGTCTGATTG-1	Enterocyte
AGAGTGGTCTGGCGTG-1	Enterocyte
AGATCTGAGCCACGTC-1	Enterocyte
AGATCTGAGCTAGGCA-1	Enterocyte
AGATCTGCACGTAAGG-1	Enterocyte
AGATCTGCATGCAACT-1	Enterocyte
AGATCTGGTGCAACTT-1	Enterocyte
AGCAGCCAGACTCGGA-1	Enterocyte
AGCAGCCCAAGTAGTA-1	Enterocyte
AGCAGCCTCGCTTAGA-1	Enterocyte
AGCATACCACTTACGA-1	Enterocyte
AGCATACCATTGAGCT-1	Enterocyte
AGCATACCATTTGCTT-1	Enterocyte
AGCCTAAAGTGGGATC-1	Enterocyte
AGCCTAACATACTACG-1	Enterocyte
AGCCTAAGTCGACTAT-1	Enterocyte
AGCCTAATCTTGAGAC-1	Enterocyte
AGCGTATAGCCGCCTA-1	Enterocyte
AGCGTATAGTCCATAC-1	Enterocyte
AGCGTATCAGATCTGT-1	Enterocyte
AGCGTATCAGCCTATA-1	Enterocyte
AGCGTATGTGCGCTTG-1	Enterocyte
AGCGTATGTGCTGTAT-1	Enterocyte
AGCGTATTCTTTACAC-1	Enterocyte
AGCGTCGAGACGACGT-1	Enterocyte
AGCGTCGAGGACCACA-1	Enterocyte
AGCGTCGAGTCCATAC-1	Enterocyte
AGCGTCGCACACTGCG-1	Enterocyte
AGCGTCGTCCTATTCA-1	Enterocyte
AGCGTCGTCCTGTACC-1	Enterocyte
AGCTCCTAGCCACTAT-1	Enterocyte
AGCTCCTAGCTGCAAG-1	Enterocyte
AGCTCCTGTGCACTTA-1	Enterocyte
AGCTCCTTCTTCTGGC-1	Enterocyte
AGCTCTCAGATGTGTA-1	Enterocyte
AGCTCTCAGTATCTCG-1	Enterocyte
AGCTCTCCAGCCTATA-1	Enterocyte
AGCTCTCCATTTCACT-1	Enterocyte
AGCTCTCGTGTAACGG-1	Enterocyte
AGCTTGAAGAGCCCAA-1	Enterocyte
AGCTTGAAGGATGGTC-1	Enterocyte
AGCTTGAGTGGCGAAT-1	Enterocyte
AGCTTGAGTTGTGGAG-1	Enterocyte
AGCTTGATCTGTGCAA-1	Enterocyte
AGGCCACAGACAAGCC-1	Enterocyte
AGGCCACGTAAATACG-1	Enterocyte
AGGCCACGTTTGACTG-1	Enterocyte
AGGCCACTCTGCGGCA-1	Enterocyte
AGGCCGTTCGGTCCGA-1	Enterocyte
AGGGAGTAGCTGCGAA-1	Enterocyte
AGGGAGTCACTATCTT-1	Enterocyte
AGGGATGCAACACGCC-1	Enterocyte
AGGGTGACAGTATAAG-1	Enterocyte
AGGGTGACATGCTAGT-1	Enterocyte
AGGGTGATCTACTTAC-1	Enterocyte
AGGTCATCACCGGAAA-1	Enterocyte
AGGTCATGTCTGATTG-1	Enterocyte
AGGTCCGCATTAGGCT-1	Enterocyte
AGTAGTCGTGTCTGAT-1	Enterocyte
AGTCTTTGTGAGGGTT-1	Enterocyte
AGTCTTTTCCCACTTG-1	Enterocyte
AGTCTTTTCCTCGCAT-1	Enterocyte
AGTGAGGCAGGCGATA-1	Enterocyte
AGTGAGGCATCCAACA-1	Enterocyte
AGTGAGGGTCGTCTTC-1	Enterocyte
AGTGAGGGTTAGGGTG-1	Enterocyte
AGTGAGGGTTCCTCCA-1	Enterocyte
AGTGAGGTCACTATTC-1	Enterocyte
AGTGGGATCTCCAACC-1	Enterocyte
AGTGGGATCTCTAGGA-1	Enterocyte
AGTGTCAAGCCACGTC-1	Enterocyte
AGTGTCACATTCTCAT-1	Enterocyte
AGTGTCATCTTGTTTG-1	Enterocyte
AGTTGGTAGCTTCGCG-1	Enterocyte
AGTTGGTGTAATTGGA-1	Enterocyte
AGTTGGTTCAACACAC-1	Enterocyte
ATAACGCAGAGCTATA-1	Enterocyte
ATAACGCAGGGTCGAT-1	Enterocyte
ATAACGCAGTTAGCGG-1	Enterocyte
ATAAGAGAGAACAATC-1	Enterocyte
ATAAGAGAGCTAGTTC-1	Enterocyte
ATAAGAGCACCTCGTT-1	Enterocyte
ATAAGAGCAGAGTGTG-1	Enterocyte
ATAAGAGCATGAAGTA-1	Enterocyte
ATAAGAGTCACATAGC-1	Enterocyte
ATAAGAGTCGACAGCC-1	Enterocyte
ATAGACCGTAAACCTC-1	Enterocyte
ATAGACCTCGCTAGCG-1	Enterocyte
ATCACGAAGACTTTCG-1	Enterocyte
ATCACGAAGAGCCTAG-1	Enterocyte
ATCACGAGTCTACCTC-1	Enterocyte
ATCACGATCTGGCGTG-1	Enterocyte
ATCATCTAGCGTGAGT-1	Enterocyte
ATCATCTGTGATGATA-1	Enterocyte
ATCATCTTCAGCACAT-1	Enterocyte
ATCATGGCAATGGACG-1	Enterocyte
ATCATGGCAATGGATA-1	Enterocyte
ATCATGGCATGCCTTC-1	Enterocyte
ATCATGGTCCATGAAC-1	Enterocyte
ATCCACCGTAGCTCCG-1	Enterocyte
ATCCGAAAGGACTGGT-1	Enterocyte
ATCCGAAAGTATCTCG-1	Enterocyte
ATCCGAAAGTTAAGTG-1	Enterocyte
ATCCGAAGTCGAGATG-1	Enterocyte
ATCCGAATCTGCAAGT-1	Enterocyte
ATCGAGTCAAGTAGTA-1	Enterocyte
ATCGAGTCATACCATG-1	Enterocyte
ATCGAGTCATCGACGC-1	Enterocyte
ATCGAGTGTCATATGC-1	Enterocyte
ATCGAGTTCGGCTACG-1	Enterocyte
ATCTACTAGCAACGGT-1	Enterocyte
ATCTACTAGCCCAGCT-1	Enterocyte
ATCTACTCATGAAGTA-1	Enterocyte
ATCTGCCAGATGCCAG-1	Enterocyte
ATCTGCCCACTTACGA-1	Enterocyte
ATCTGCCCATCGATGT-1	Enterocyte
ATCTGCCCATTAACCG-1	Enterocyte
ATCTGCCGTATAAACG-1	Enterocyte
ATCTGCCTCAAGGTAA-1	Enterocyte
ATCTGCCTCTGCTGCT-1	Enterocyte
ATGAGGGAGCTACCGC-1	Enterocyte
ATGAGGGCAAAGCGGT-1	Enterocyte
ATGAGGGCACACGCTG-1	Enterocyte
ATGAGGGCAGGCTGAA-1	Enterocyte
ATGAGGGGTACAGTTC-1	Enterocyte
ATGAGGGTCGGCTACG-1	Enterocyte
ATGCGATCACATTTCT-1	Enterocyte
ATGCGATTCCGAACGC-1	Enterocyte
ATGGGAGCACAGCGTC-1	Enterocyte
ATGGGAGCATCCCACT-1	Enterocyte
ATGGGAGTCTTACCTA-1	Enterocyte
ATGTGTGCACCGAATT-1	Enterocyte
ATGTGTGGTACCGCTG-1	Enterocyte
ATGTGTGGTTCGAATC-1	Enterocyte
ATGTGTGTCTTGCCGT-1	Enterocyte
ATTACTCAGAGTAATC-1	Enterocyte
ATTACTCGTACCTACA-1	Enterocyte
ATTACTCGTATAGGTA-1	Enterocyte
ATTACTCTCAGTACGT-1	Enterocyte
ATTACTCTCAGTGTTG-1	Enterocyte
ATTATCCAGAGGTAGA-1	Enterocyte
ATTATCCCAGCTATTG-1	Enterocyte
ATTATCCGTAAACACA-1	Enterocyte
ATTATCCGTCCAGTTA-1	Enterocyte
ATTCTACAGTGTACCT-1	Enterocyte
ATTCTACCATACGCTA-1	Enterocyte
ATTGGACAGGGTCGAT-1	Enterocyte
ATTGGACAGTGGCACA-1	Enterocyte
ATTGGACTCCACGTGG-1	Enterocyte
ATTGGACTCCTACAGA-1	Enterocyte
ATTGGACTCGAGAACG-1	Enterocyte
ATTGGTGAGCCCTAAT-1	Enterocyte
ATTGGTGTCAGCTCGG-1	Enterocyte
ATTTCTGAGGTGCTTT-1	Enterocyte
ATTTCTGGTACGACCC-1	Enterocyte
ATTTCTGTCGCATGAT-1	Enterocyte
CAACCAAAGCAATCTC-1	Enterocyte
CAACCAAAGCTTATCG-1	Enterocyte
CAACCTCAGCGTCAAG-1	Enterocyte
CAACCTCAGGGAAACA-1	Enterocyte
CAACCTCTCGACAGCC-1	Enterocyte
CAACTAGAGCCGATTT-1	Enterocyte
CAACTAGCATGCAATC-1	Enterocyte
CAACTAGGTAGCGTCC-1	Enterocyte
CAACTAGTCCGCAAGC-1	Enterocyte
CAACTAGTCCTCGCAT-1	Enterocyte
CAACTAGTCGCCAGCA-1	Enterocyte
CAAGATCAGCTAAGAT-1	Enterocyte
CAAGATCTCCAGTATG-1	Enterocyte
CAAGATCTCGTAGGTT-1	Enterocyte
CAAGATCTCTTAGCCC-1	Enterocyte
CAAGGCCAGCTGAACG-1	Enterocyte
CAAGTTGGTCGAACAG-1	Enterocyte
CACAAACAGACAATAC-1	Enterocyte
CACAAACAGTGAAGAG-1	Enterocyte
CACAAACTCACATACG-1	Enterocyte
CACACAAAGAAAGTGG-1	Enterocyte
CACACAACAACTGGCC-1	Enterocyte
CACACAACAGTCAGAG-1	Enterocyte
CACACCTAGAATGTGT-1	Enterocyte
CACACTCAGCCACGCT-1	Enterocyte
CACAGTAAGTTCGCGC-1	Enterocyte
CACAGTATCGGAATCT-1	Enterocyte
CACAGTATCTACCTGC-1	Enterocyte
CACAGTATCTCACATT-1	Enterocyte
CACATAGGTGGCAAAC-1	Enterocyte
CACATTTGTGCCTGCA-1	Enterocyte
CACCAGGAGAGCCCAA-1	Enterocyte
CACCAGGCAAGTACCT-1	Enterocyte
CACCAGGCATTTGCTT-1	Enterocyte
CACCAGGGTCTGCCAG-1	Enterocyte
CACCTTGAGATAGCAT-1	Enterocyte
CACCTTGCATGGAATA-1	Enterocyte
CACCTTGGTTCATGGT-1	Enterocyte
CACCTTGTCACTTCAT-1	Enterocyte
CACCTTGTCAGGCCCA-1	Enterocyte
CAGAATCAGAATGTTG-1	Enterocyte
CAGAATCGTATCACCA-1	Enterocyte
CAGAATCGTGCACTTA-1	Enterocyte
CAGAGAGCAGTAGAGC-1	Enterocyte
CAGAGAGTCCACGAAT-1	Enterocyte
CAGATCACACACCGAC-1	Enterocyte
CAGATCACATCCAACA-1	Enterocyte
CAGATCATCAACACAC-1	Enterocyte
CAGATCATCAGATAAG-1	Enterocyte
CAGATCATCGTTTAGG-1	Enterocyte
CAGCAGCGTACCGGCT-1	Enterocyte
CAGCAGCTCGTCGTTC-1	Enterocyte
CAGCATAAGTCGTACT-1	Enterocyte
CAGCATAAGTTACCCA-1	Enterocyte
CAGCATAGTCAAGCGA-1	Enterocyte
CAGCATATCAGCAACT-1	Enterocyte
CAGCCGAGTCACCCAG-1	Enterocyte
CAGCCGAGTTGATTCG-1	Enterocyte
CAGCCGATCCCACTTG-1	Enterocyte
CAGCGACAGATCTGAA-1	Enterocyte
CAGCGACCAACAACCT-1	Enterocyte
CAGCGACCATAACCTG-1	Enterocyte
CAGCGACGTATCACCA-1	Enterocyte
CAGCTAATCACAATGC-1	Enterocyte
CAGCTGGCAGTCCTTC-1	Enterocyte
CAGCTGGTCCTTTCTC-1	Enterocyte
CAGTAACAGGCAATTA-1	Enterocyte
CAGTAACTCCTCAACC-1	Enterocyte
CAGTAACTCTCCAGGG-1	Enterocyte
CAGTCCTGTCAGAGGT-1	Enterocyte
CAGTCCTGTCCAAGTT-1	Enterocyte
CATATGGTCTACGAGT-1	Enterocyte
CATATGGTCTTCCTTC-1	Enterocyte
CATATTCAGAGTGAGA-1	Enterocyte
CATATTCAGCCAGTAG-1	Enterocyte
CATATTCCATTCCTGC-1	Enterocyte
CATCAGAAGCACGCCT-1	Enterocyte
CATCAGACAAAGTCAA-1	Enterocyte
CATCAGACACCGATAT-1	Enterocyte
CATCCACAGAAGGCCT-1	Enterocyte
CATCCACAGGTGCAAC-1	Enterocyte
CATCCACCAAGCTGGA-1	Enterocyte
CATCGAAGTGTGGCTC-1	Enterocyte
CATCGAATCGGTCTAA-1	Enterocyte
CATCGAATCTTTACGT-1	Enterocyte
CATCGGGAGATATGCA-1	Enterocyte
CATCGGGCACCCAGTG-1	Enterocyte
CATCGGGTCGTTACAG-1	Enterocyte
CATGACACAATTGCTG-1	Enterocyte
CATGACATCGAGGTAG-1	Enterocyte
CATGACATCTTGCATT-1	Enterocyte
CATGCCTAGTCGATAA-1	Enterocyte
CATGCCTGTAGTACCT-1	Enterocyte
CATGCCTGTCTAGCCG-1	Enterocyte
CATGCCTTCAACACAC-1	Enterocyte
CATGCCTTCTTCGGTC-1	Enterocyte
CATGGCGAGCACACAG-1	Enterocyte
CATGGCGCAGCTGCTG-1	Enterocyte
CATGGCGGTGGGTCAA-1	Enterocyte
CATGGCGTCACCTTAT-1	Enterocyte
CATGGCGTCAGAGCTT-1	Enterocyte
CATTATCAGAGTCGGT-1	Enterocyte
CATTATCCAGTATGCT-1	Enterocyte
CATTATCCATCGTCGG-1	Enterocyte
CATTATCTCACATAGC-1	Enterocyte
CATTCGCTCTATCCCG-1	Enterocyte
CCAATCCAGAACAATC-1	Enterocyte
CCAATCCCAATCGAAA-1	Enterocyte
CCAATCCCATTGAGCT-1	Enterocyte
CCAATCCTCTGTACGA-1	Enterocyte
CCACCTAAGCGATGAC-1	Enterocyte
CCACCTAGTCTGATTG-1	Enterocyte
CCACCTAGTTAAGATG-1	Enterocyte
CCACGGAAGAATGTGT-1	Enterocyte
CCACGGATCGACCAGC-1	Enterocyte
CCACTACAGAGCAATT-1	Enterocyte
CCACTACCACATGACT-1	Enterocyte
CCACTACTCAAGGCTT-1	unclassified
CCATGTCAGGGTTCCC-1	Enterocyte
CCATGTCCACAAGACG-1	Enterocyte
CCATGTCCAGCTCCGA-1	Enterocyte
CCATTCGAGGGTTCCC-1	Enterocyte
CCATTCGCACGCATCG-1	Enterocyte
CCATTCGCAGGTGCCT-1	Enterocyte
CCATTCGTCAGTTGAC-1	Enterocyte
CCCAATCAGATCCCAT-1	Enterocyte
CCCAATCAGCTAAACA-1	Enterocyte
CCCAATCCAGCTATTG-1	Enterocyte
CCCAATCGTAAATGTG-1	Enterocyte
CCCAGTTCATCTCGCT-1	Enterocyte
CCCAGTTCATGATCCA-1	Enterocyte
CCCAGTTTCGGGAGTA-1	Enterocyte
CCCATACGTCTCTTAT-1	Enterocyte
CCCATACTCTATCGCC-1	Enterocyte
CCCTCCTGTAGCGTCC-1	Enterocyte
CCCTCCTTCACAGGCC-1	Enterocyte
CCCTCCTTCCTATTCA-1	Enterocyte
CCGTACTTCCAAAGTC-1	Enterocyte
CCGTGGACAATAACGA-1	Enterocyte
CCGTGGATCACAATGC-1	Enterocyte
CCGTTCATCTGAGTGT-1	Enterocyte
CCTAAAGAGAGACGAA-1	Enterocyte
CCTAAAGCATGAGCGA-1	Enterocyte
CCTAAAGTCACTTCAT-1	Enterocyte
CCTAAAGTCTAACCGA-1	Enterocyte
CCTAGCTCATCGTCGG-1	Enterocyte
CCTAGCTCATGCGCAC-1	Enterocyte
CCTAGCTTCCGCAGTG-1	Enterocyte
CCTAGCTTCTGCTGTC-1	Enterocyte
CCTATTAAGATGTTAG-1	Enterocyte
CCTATTAGTCTAGAGG-1	Enterocyte
CCTCAGTGTCGCATAT-1	Enterocyte
CCTCAGTGTCTGATTG-1	Enterocyte
CCTCAGTTCGCCGTGA-1	Enterocyte
CCTCAGTTCTCCAACC-1	Enterocyte
CCTTACGAGAATGTGT-1	Enterocyte
CCTTACGCAAAGCGGT-1	Enterocyte
CCTTACGCATGAACCT-1	Enterocyte
CCTTACGGTCGGCTCA-1	Enterocyte
CCTTCCCGTTGAACTC-1	Enterocyte
CCTTCCCTCCTCAATT-1	Enterocyte
CCTTCCCTCGTTTAGG-1	Enterocyte
CCTTCGATCGCGGATC-1	Enterocyte
CCTTTCTCACAACTGT-1	Enterocyte
CCTTTCTGTTGTCGCG-1	Enterocyte
CCTTTCTTCACATGCA-1	Enterocyte
CCTTTCTTCATTCACT-1	Enterocyte
CCTTTCTTCCACTCCA-1	Enterocyte
CGAACATAGGAGTTGC-1	Enterocyte
CGAACATAGGCGCTCT-1	Enterocyte
CGAACATAGTCCAGGA-1	Enterocyte
CGAACATCACGTGAGA-1	Enterocyte
CGAACATGTAGCACGA-1	Enterocyte
CGAACATGTTCCACAA-1	Enterocyte
CGAATGTAGAGCTGCA-1	Enterocyte
CGAATGTCATCAGTAC-1	Enterocyte
CGAATGTGTTTAAGCC-1	Enterocyte
CGACCTTAGCAATATG-1	Enterocyte
CGACCTTAGCCAGTAG-1	Enterocyte
CGACCTTCAGTATAAG-1	Enterocyte
CGACCTTTCGGCGGTT-1	Enterocyte
CGACTTCAGACAAGCC-1	Enterocyte
CGACTTCAGTGGAGAA-1	Enterocyte
CGACTTCAGTGTGGCA-1	Enterocyte
CGACTTCCAATCACAC-1	Enterocyte
CGACTTCGTGGAAAGA-1	Enterocyte
CGAGAAGAGACAAAGG-1	Enterocyte
CGAGAAGAGTCTCCTC-1	Enterocyte
CGAGAAGCAGGTTTCA-1	Enterocyte
CGAGAAGGTGTTGGGA-1	Enterocyte
CGAGCACCAGGCAGTA-1	Enterocyte
CGAGCACTCGGTCCGA-1	Enterocyte
CGAGCCAAGGTTCCTA-1	Enterocyte
CGAGCCACAATCGGTT-1	Enterocyte
CGAGCCACACGGCGTT-1	Enterocyte
CGAGCCACATCGATTG-1	Enterocyte
CGAGCCAGTAGTACCT-1	Enterocyte
CGAGCCATCAGGTTCA-1	Enterocyte
CGAGCCATCTCCGGTT-1	Enterocyte
CGAGCCATCTGGCGTG-1	Enterocyte
CGATCGGAGCGTAGTG-1	Enterocyte
CGATCGGCAATAGCGG-1	Enterocyte
CGATCGGGTAAGTTCC-1	Enterocyte
CGATCGGGTAGGCATG-1	Enterocyte
CGATCGGGTGGTGTAG-1	Enterocyte
CGATCGGTCACCCGAG-1	Enterocyte
CGATGGCCACAGGCCT-1	Enterocyte
CGATGGCGTCGGCACT-1	Enterocyte
CGATGTAAGCGGATCA-1	Enterocyte
CGATGTAGTAATAGCA-1	Enterocyte
CGATGTAGTACAGTGG-1	Enterocyte
CGATGTAGTGGCTCCA-1	Enterocyte
CGATTGAAGAGGTAGA-1	Enterocyte
CGCCAAGCAGGCTGAA-1	Enterocyte
CGCGGTAAGACTAGAT-1	Enterocyte
CGCGGTAAGTTACGGG-1	Enterocyte
CGCGGTACAAAGTCAA-1	Enterocyte
CGCGGTAGTGTGAATA-1	Enterocyte
CGCGTTTGTTCAGCGC-1	Enterocyte
CGCTATCGTAAAGTCA-1	Enterocyte
CGCTATCGTACGCTGC-1	Enterocyte
CGCTATCGTCATATCG-1	Enterocyte
CGCTATCGTGCTTCTC-1	Enterocyte
CGCTATCTCAACGGCC-1	Enterocyte
CGCTGGAAGGATGCGT-1	Enterocyte
CGCTGGACACGAAATA-1	Enterocyte
CGCTGGAGTGCATCTA-1	Enterocyte
CGCTGGATCTGATACG-1	Enterocyte
CGCTTCAAGCCACCTG-1	Enterocyte
CGCTTCACACTACAGT-1	Enterocyte
CGCTTCATCCAATGGT-1	Enterocyte
CGCTTCATCTCCAACC-1	Enterocyte
CGGACACAGTGGGCTA-1	Enterocyte
CGGACACGTTCTGTTT-1	Enterocyte
CGGACACTCAACCAAC-1	Enterocyte
CGGACACTCAGCTTAG-1	Enterocyte
CGGACGTCACAGATTC-1	Enterocyte
CGGACGTTCACTTACT-1	Enterocyte
CGGACGTTCATTATCC-1	Enterocyte
CGGACTGAGAAGATTC-1	Enterocyte
CGGACTGGTATCGCAT-1	Enterocyte
CGGACTGTCCGCAAGC-1	Enterocyte
CGGAGCTCATAGGATA-1	Enterocyte
CGGAGCTCATGCCACG-1	Enterocyte
CGGAGCTGTATAGTAG-1	Enterocyte
CGGAGCTTCACATACG-1	Enterocyte
CGGAGCTTCGTAGGTT-1	Enterocyte
CGGAGTCGTAATCACC-1	Enterocyte
CGGAGTCGTCCGCTGA-1	Enterocyte
CGGGTCAGTGTTCTTT-1	Enterocyte
CGGGTCAGTTCATGGT-1	Enterocyte
CGGTTAAAGAAGGCCT-1	Enterocyte
CGGTTAAAGATAGTCA-1	Enterocyte
CGGTTAAAGCCAACAG-1	Enterocyte
CGGTTAACAATAGAGT-1	Enterocyte
CGGTTAACATCGGGTC-1	Enterocyte
CGGTTAAGTATAAACG-1	Enterocyte
CGGTTAATCCAGAGGA-1	Enterocyte
CGTAGCGAGGGTCGAT-1	Enterocyte
CGTAGCGAGTCCAGGA-1	Enterocyte
CGTCACTCAAATCCGT-1	Enterocyte
CGTCACTCAGGCAGTA-1	Enterocyte
CGTCAGGAGCTGTTCA-1	Enterocyte
CGTCAGGAGGAGCGTT-1	Enterocyte
CGTCAGGAGGTGGGTT-1	Enterocyte
CGTCAGGTCAACACTG-1	Enterocyte
CGTCCATAGGAGCGTT-1	Enterocyte
CGTCCATAGTACCGGA-1	Enterocyte
CGTCCATTCGAATGCT-1	Enterocyte
CGTGAGCCAGCTTCGG-1	Enterocyte
CGTGAGCTCACTCCTG-1	Enterocyte
CGTGAGCTCAGCTGGC-1	Enterocyte
CGTGTAAAGGATCGCA-1	Enterocyte
CGTGTAAAGGTAGCTG-1	Enterocyte
CGTGTAATCCTATTCA-1	Enterocyte
CGTGTAATCGTCACGG-1	Enterocyte
CGTGTCTAGTCGTACT-1	Enterocyte
CGTGTCTTCAGGCCCA-1	Enterocyte
CGTTAGAGTGTTGAGG-1	Enterocyte
CGTTCTGGTTACTGAC-1	Enterocyte
CGTTGGGCAAACAACA-1	Enterocyte
CTAACTTAGATGGCGT-1	Enterocyte
CTAACTTCAATACGCT-1	Enterocyte
CTAACTTCAGTTTACG-1	Enterocyte
CTAACTTGTGTGAATA-1	Enterocyte
CTAAGACGTGACGCCT-1	Enterocyte
CTAAGACGTTGCGCAC-1	Enterocyte
CTAATGGCAGACTCGC-1	Enterocyte
CTAATGGCAGCCTTGG-1	Enterocyte
CTAATGGCATCCGCGA-1	Enterocyte
CTAATGGGTAGCGCAA-1	Enterocyte
CTAATGGGTTCGGGCT-1	Enterocyte
CTACCCAAGAATAGGG-1	Enterocyte
CTACGTCGTGCACGAA-1	Enterocyte
CTACGTCTCCTCAACC-1	Enterocyte
CTACGTCTCTACGAGT-1	Enterocyte
CTAGAGTTCAGGCCCA-1	Enterocyte
CTAGAGTTCATGGTCA-1	Enterocyte
CTAGCCTAGAAGGGTA-1	Enterocyte
CTAGCCTAGTCATGCT-1	Enterocyte
CTAGCCTAGTTATCGC-1	Enterocyte
CTAGCCTCACCGAAAG-1	Enterocyte
CTAGCCTGTCCGTTAA-1	Enterocyte
CTAGCCTTCGGCCGAT-1	Enterocyte
CTCACACAGGGTTCCC-1	Enterocyte
CTCAGAACAGTGGGAT-1	Enterocyte
CTCAGAACAGTTCCCT-1	Enterocyte
CTCAGAAGTGCGCTTG-1	Enterocyte
CTCAGAATCGAGAACG-1	Enterocyte
CTCAGAATCTTGCATT-1	Enterocyte
CTCATTAAGCCAACAG-1	Enterocyte
CTCATTACACACAGAG-1	Enterocyte
CTCATTACACATCCGG-1	Enterocyte
CTCATTACACCAGGCT-1	Enterocyte
CTCATTAGTCACACGC-1	Enterocyte
CTCATTAGTTCAACCA-1	Enterocyte
CTCATTATCCAGATCA-1	Enterocyte
CTCCTAGAGGGCATGT-1	Enterocyte
CTCCTAGGTGCTTCTC-1	Enterocyte
CTCCTAGTCGAGAACG-1	Enterocyte
CTCGAAAAGGCGATAC-1	Enterocyte
CTCGAAACAGCCAATT-1	Enterocyte
CTCGAAAGTCACTTCC-1	Enterocyte
CTCGAAAGTTGGTAAA-1	Enterocyte
CTCGAGGAGCGTAGTG-1	Enterocyte
CTCGAGGCACCATCCT-1	Enterocyte
CTCGAGGCACCGGAAA-1	Enterocyte
CTCGAGGGTTACGTCA-1	Enterocyte
CTCGGAGAGAACAATC-1	Enterocyte
CTCGGAGAGATCTGCT-1	Enterocyte
CTCGGAGCACATCTTT-1	Enterocyte
CTCGGAGTCAGGTAAA-1	Enterocyte
CTCGGGAAGTGCTGCC-1	Enterocyte
CTCGGGAGTCGGCTCA-1	Enterocyte
CTCGGGATCAAGAAGT-1	Enterocyte
CTCGGGATCGCGCCAA-1	Enterocyte
CTCGTACAGCCACGCT-1	Enterocyte
CTCGTACAGCCACTAT-1	Enterocyte
CTCGTACTCGTGGGAA-1	Enterocyte
CTCGTCAGTCTTCTCG-1	Enterocyte
CTCTACGCAATAAGCA-1	Enterocyte
CTCTACGCACTGTCGG-1	Enterocyte
CTCTACGGTACCGAGA-1	Enterocyte
CTGAAACAGAAGGTGA-1	Enterocyte
CTGAAACTCCGAAGAG-1	Enterocyte
CTGAAGTCACCTCGGA-1	Enterocyte
CTGAAGTCAGGTCTCG-1	Enterocyte
CTGATAGAGATGCCTT-1	Enterocyte
CTGATCCAGCAGGTCA-1	Enterocyte
CTGATCCCATTTCAGG-1	Enterocyte
CTGATCCGTGCCTGGT-1	Enterocyte
CTGATCCGTTTAGGAA-1	Enterocyte
CTGATCCTCGGCGGTT-1	Enterocyte
CTGCCTAAGTCGAGTG-1	Enterocyte
CTGCCTAAGTGGCACA-1	Enterocyte
CTGCCTACAAAGGAAG-1	Enterocyte
CTGCCTACACGGTGTC-1	Enterocyte
CTGCCTACATTTGCTT-1	Enterocyte
CTGCCTAGTCAGAATA-1	Enterocyte
CTGCGGAAGTAATCCC-1	Enterocyte
CTGCGGAAGTAGGTGC-1	Enterocyte
CTGCGGACATCCCATC-1	Enterocyte
CTGCGGAGTCATGCAT-1	Enterocyte
CTGCGGATCCCAAGTA-1	Enterocyte
CTGCTGTCACGGTAAG-1	Enterocyte
CTGCTGTCATTAACCG-1	Enterocyte
CTGCTGTGTCCGAATT-1	Enterocyte
CTGCTGTGTGACCAAG-1	Enterocyte
CTGCTGTTCCCGACTT-1	Enterocyte
CTGGTCTAGTGCTGCC-1	Enterocyte
CTGTGCTAGTGTCCAT-1	Enterocyte
CTGTGCTCAGTCGTGC-1	Enterocyte
CTGTGCTTCACATAGC-1	Enterocyte
CTGTTTACACACTGCG-1	Enterocyte
CTTAACTAGGCTACGA-1	Enterocyte
CTTAACTAGGTGACCA-1	Enterocyte
CTTAACTCATGCCTTC-1	Enterocyte
CTTAACTTCTCTGTCG-1	Enterocyte
CTTACCGAGGGTGTGT-1	Enterocyte
CTTACCGGTCACTGGC-1	Enterocyte
CTTACCGTCATTGCGA-1	Enterocyte
CTTACCGTCCCTGACT-1	Enterocyte
CTTAGGAGTGTGCCTG-1	Enterocyte
CTTCTCTAGAGAACAG-1	Enterocyte
CTTCTCTAGCAGGCTA-1	Enterocyte
CTTCTCTCATGGTTGT-1	Enterocyte
CTTCTCTGTTATGCGT-1	Enterocyte
CTTCTCTTCAGCTTAG-1	Enterocyte
CTTCTCTTCGCGTTTC-1	Enterocyte
CTTGGCTAGTCAAGCG-1	Enterocyte
CTTGGCTCAAGCGATG-1	Enterocyte
CTTGGCTCACTTACGA-1	Enterocyte
GAAACTCCATGTCGAT-1	Enterocyte
GAAATGAAGGCATGGT-1	Enterocyte
GAACATCGTGGCTCCA-1	Enterocyte
GAACATCTCATGTCTT-1	Enterocyte
GAACATCTCATTATCC-1	Enterocyte
GAACATCTCGAACTGT-1	Enterocyte
GAACCTAGTGCACGAA-1	Enterocyte
GAACCTATCTCGCATC-1	Enterocyte
GAACGGAAGATCACGG-1	Enterocyte
GAACGGAAGGTTCCTA-1	Enterocyte
GAACGGATCTGCCCTA-1	Enterocyte
GAAGCAGAGCACCGCT-1	Enterocyte
GAAGCAGCACAGACTT-1	Enterocyte
GAAGCAGTCTTAGAGC-1	Enterocyte
GAATAAGGTATGCTTG-1	Enterocyte
GAATAAGGTGATAAAC-1	Enterocyte
GAATAAGGTTATCGGT-1	Enterocyte
GAATAAGTCATTATCC-1	Enterocyte
GAATGAATCAGATAAG-1	Enterocyte
GAATGAATCTTTAGGG-1	Enterocyte
GACACGCAGAAGGTGA-1	Enterocyte
GACAGAGAGCTATGCT-1	Enterocyte
GACAGAGAGCTCTCGG-1	Enterocyte
GACAGAGAGGAGTTTA-1	Enterocyte
GACCAATAGCTGATAA-1	Enterocyte
GACCAATCAACTTGAC-1	Enterocyte
GACCAATCACAGACAG-1	Enterocyte
GACCAATTCACTTCAT-1	Enterocyte
GACCAATTCGAGAACG-1	Enterocyte
GACCAATTCTTATCTG-1	Enterocyte
GACCTGGCACGAGAGT-1	Enterocyte
GACCTGGCAGATGAGC-1	Enterocyte
GACCTGGGTTGTGGCC-1	Enterocyte
GACCTGGTCGGACAAG-1	Enterocyte
GACCTGGTCTGCGTAA-1	Enterocyte
GACGCGTCATTGGTAC-1	Enterocyte
GACGCGTGTCGGCTCA-1	Enterocyte
GACGGCTGTCATCGGC-1	unclassified
GACGGCTGTTCACCTC-1	Enterocyte
GACGGCTTCACGAAGG-1	Enterocyte
GACGTGCAGAGGGCTT-1	Enterocyte
GACGTGCAGCTAACTC-1	Enterocyte
GACGTGCCATCGGTTA-1	Enterocyte
GACGTTATCGAGCCCA-1	Enterocyte
GACTAACAGCTGAAAT-1	Enterocyte
GACTAACGTTGCCTCT-1	Enterocyte
GACTACAAGCGAGAAA-1	Enterocyte
GACTACAAGGAGCGAG-1	Enterocyte
GACTACAAGGGATACC-1	Enterocyte
GACTACAGTCAGAAGC-1	Enterocyte
GACTGCGAGTGTCCCG-1	Enterocyte
GACTGCGTCTGCAAGT-1	Enterocyte
GACTGCGTCTGCCCTA-1	Enterocyte
GAGCAGAAGACGCTTT-1	Enterocyte
GAGCAGAGTATATCCG-1	Enterocyte
GAGGTGAAGACGCAAC-1	Enterocyte
GAGGTGACAATGGACG-1	Enterocyte
GAGGTGACAGCTGGCT-1	Enterocyte
GAGGTGACAGTCAGAG-1	Enterocyte
GAGGTGATCAGTTTGG-1	Enterocyte
GAGTCCGAGCTGTCTA-1	Enterocyte
GAGTCCGAGGGATCTG-1	Enterocyte
GATCAGTAGATGAGAG-1	Enterocyte
GATCAGTCATGTCCTC-1	Enterocyte
GATCAGTGTAGTACCT-1	Enterocyte
GATCAGTTCAAGATCC-1	Enterocyte
GATCGATCACTGTGTA-1	Enterocyte
GATCGCGTCCATGAGT-1	Enterocyte
GATCGTAAGCATCATC-1	Enterocyte
GATCGTACACGGCTAC-1	Enterocyte
GATCTAGAGATGCCAG-1	Enterocyte
GATCTAGCATCACAAC-1	Enterocyte
GATCTAGGTCCATCCT-1	Enterocyte
GATCTAGTCGACAGCC-1	Enterocyte
GATGAAACATCCTAGA-1	Enterocyte
GATGAAACATCGATGT-1	Enterocyte
GATGAGGAGCCGTCGT-1	Enterocyte
GATGAGGCAACAACCT-1	Enterocyte
GATGAGGCAGCCTTGG-1	Enterocyte
GATGAGGGTGATGTCT-1	Enterocyte
GATGAGGGTTACCAGT-1	Enterocyte
GATGAGGTCATTCACT-1	Enterocyte
GATGCTAAGATCACGG-1	Enterocyte
GATGCTACACATTCGA-1	Enterocyte
GATGCTAGTCTGATCA-1	Enterocyte
GATGCTAGTGGTCTCG-1	Enterocyte
GATTCAGCAAGAAAGG-1	Enterocyte
GATTCAGCACGACTCG-1	Enterocyte
GATTCAGTCCTCAACC-1	Enterocyte
GCAAACTAGACGCAAC-1	Enterocyte
GCAAACTAGGATTCGG-1	Enterocyte
GCAAACTCACAGGAGT-1	Enterocyte
GCAAACTTCGAACGGA-1	Enterocyte
GCAATCACAACACCTA-1	Enterocyte
GCAATCAGTAGTGAAT-1	Enterocyte
GCAATCATCGCAAACT-1	Enterocyte
GCACATAGTCTAACGT-1	Enterocyte
GCACTCTCACGCGAAA-1	Enterocyte
GCACTCTCATCCCATC-1	Enterocyte
GCACTCTGTTGGACCC-1	Enterocyte
GCAGTTAGTTGGGACA-1	Enterocyte
GCATACAGTCTAGTGT-1	Enterocyte
GCATACAGTGAACCTT-1	Enterocyte
GCATGATAGAAACGAG-1	Enterocyte
GCATGATCACTCAGGC-1	Enterocyte
GCATGATGTAATTGGA-1	Enterocyte
GCATGCGAGTTAAGTG-1	Enterocyte
GCATGCGCAGATCGGA-1	Enterocyte
GCATGCGTCATCGCTC-1	Enterocyte
GCCAAATAGCGATAGC-1	Enterocyte
GCCAAATAGTCGCCGT-1	Enterocyte
GCCTCTACAGATAATG-1	Enterocyte
GCCTCTAGTCAAACTC-1	Enterocyte
GCGACCAAGTCTCCTC-1	Enterocyte
GCGACCATCAAACCAC-1	Enterocyte
GCGACCATCCAAGTAC-1	Enterocyte
GCGAGAAAGCTGAACG-1	Enterocyte
GCGAGAACAATCTGCA-1	Enterocyte
GCGAGAACACCGGAAA-1	Enterocyte
GCGAGAACATACTCTT-1	Enterocyte
GCGCAACAGGGCACTA-1	Enterocyte
GCGCAACGTCATCGGC-1	Enterocyte
GCGCAGTAGCATGGCA-1	Enterocyte
GCGCAGTCAATTGCTG-1	Enterocyte
GCGCAGTGTGCACGAA-1	Enterocyte
GCGCAGTGTTAAGACA-1	Enterocyte
GCGCAGTTCTATCCTA-1	Enterocyte
GCGCCAAAGATATGCA-1	Enterocyte
GCGCCAAAGCTAGTGG-1	Enterocyte
GCGCGATAGCGTAGTG-1	Enterocyte
GCGCGATCAACACCCG-1	Enterocyte
GCGCGATGTAAACCTC-1	Enterocyte
GCGGGTTAGAGCTATA-1	Enterocyte
GCGGGTTCACCACGTG-1	Enterocyte
GCGGGTTGTTCGCTAA-1	Enterocyte
GCTCCTATCGTATCAG-1	Enterocyte
GCTCTGTAGATGGGTC-1	Enterocyte
GCTCTGTTCGTGACAT-1	Enterocyte
GCTGCAGGTATTCTCT-1	Enterocyte
GCTGCGAAGAAGCCCA-1	Enterocyte
GCTGCGAAGGGCTTCC-1	Enterocyte
GCTGCGACAGACAAAT-1	Enterocyte
GCTGCGATCCTTTCGG-1	Enterocyte
GCTGCGATCGGTTCGG-1	Enterocyte
GCTGCTTCAAGAAGAG-1	Enterocyte
GCTGCTTTCTTGCAAG-1	Enterocyte
GCTGGGTCACGGTTTA-1	Enterocyte
GCTGGGTTCAGTTCGA-1	Enterocyte
GCTGGGTTCATCGGAT-1	Enterocyte
GCTGGGTTCGCGCCAA-1	Enterocyte
GCTTCCAAGAGGTTGC-1	Enterocyte
GCTTCCATCTTTAGTC-1	Enterocyte
GCTTGAAAGACCTTTG-1	Enterocyte
GCTTGAAAGCTGCCCA-1	Enterocyte
GCTTGAAAGGGAACGG-1	Enterocyte
GCTTGAATCCGAATGT-1	Enterocyte
GGAAAGCGTATCACCA-1	Enterocyte
GGAAAGCGTCTCCCTA-1	Enterocyte
GGAAAGCTCTACTATC-1	Enterocyte
GGAACTTAGCAAATCA-1	Enterocyte
GGAACTTGTGGGTCAA-1	Enterocyte
GGAACTTTCTCTGCTG-1	Enterocyte
GGAATAAAGCCGCCTA-1	Enterocyte
GGAATAACAATGGACG-1	Enterocyte
GGAATAACACCGCTAG-1	Enterocyte
GGACAAGAGACTCGGA-1	Enterocyte
GGACAAGGTCCATCCT-1	Enterocyte
GGACAAGGTTCGTCTC-1	Enterocyte
GGACAAGTCAAACCAC-1	Enterocyte
GGACAGACAGTCAGAG-1	Enterocyte
GGACAGAGTGGCCCTA-1	Enterocyte
GGACATTAGGAGTTGC-1	Enterocyte
GGACGTCAGTGAACGC-1	Enterocyte
GGACGTCCAATGCCAT-1	Enterocyte
GGACGTCTCCGCATCT-1	Enterocyte
GGAGCAACAATCAGAA-1	Enterocyte
GGAGCAACATAGTAAG-1	Enterocyte
GGAGCAAGTAGAGGAA-1	Enterocyte
GGAGCAATCGAACTGT-1	Enterocyte
GGATGTTAGCTATGCT-1	Enterocyte
GGATGTTGTCAGAATA-1	Enterocyte
GGATTACAGATCGATA-1	Enterocyte
GGATTACTCTAGCACA-1	Enterocyte
GGCAATTAGTCGTTTG-1	Enterocyte
GGCCGATAGCGTCAAG-1	Enterocyte
GGCCGATCAGTAAGCG-1	Enterocyte
GGCCGATCATGGTCTA-1	Enterocyte
GGCCGATGTATAGGGC-1	Enterocyte
GGCCGATGTCTAGTGT-1	Enterocyte
GGCGACTCAAGCTGGA-1	Enterocyte
GGCGACTCATCAGTCA-1	Enterocyte
GGCGACTCATCATCCC-1	Enterocyte
GGCGACTGTTGGAGGT-1	Enterocyte
GGCGTGTCACACAGAG-1	Enterocyte
GGCGTGTGTATCGCAT-1	Enterocyte
GGCGTGTGTCTAGCGC-1	Enterocyte
GGCTCGAAGAAACGCC-1	Enterocyte
GGCTCGAAGAACTCGG-1	Enterocyte
GGCTCGAAGCGCTTAT-1	Enterocyte
GGCTCGACAGCGAACA-1	Enterocyte
GGCTCGAGTCATCCCT-1	Enterocyte
GGCTCGAGTCTTCTCG-1	Enterocyte
GGCTCGATCCAACCAA-1	Enterocyte
GGCTGGTAGGGCTTGA-1	Enterocyte
GGCTGGTCAGATTGCT-1	Enterocyte
GGGAATGAGGCAGTCA-1	Enterocyte
GGGAATGAGGTGCTAG-1	Enterocyte
GGGACCTAGCTTCGCG-1	Enterocyte
GGGACCTGTCATGCAT-1	Enterocyte
GGGACCTGTTAGATGA-1	Enterocyte
GGGACCTTCACCGGGT-1	Enterocyte
GGGAGATAGACTTGAA-1	Enterocyte
GGGAGATTCCCTTGTG-1	Enterocyte
GGGATGAAGCTGCAAG-1	Enterocyte
GGGATGAAGTACGACG-1	Enterocyte
GGGATGACAATGGAAT-1	Enterocyte
GGGATGAGTTGTGGCC-1	Enterocyte
GGGCACTAGGTGCAAC-1	Enterocyte
GGGCACTGTTTCCACC-1	Enterocyte
GGGCACTTCTTGTACT-1	Enterocyte
GGGCATCGTGACGCCT-1	Enterocyte
GGGCATCGTGAGGGAG-1	Enterocyte
GGGTCTGAGGTTCCTA-1	Enterocyte
GGGTCTGCATAACCTG-1	Enterocyte
GGGTTGCAGATACACA-1	Enterocyte
GGGTTGCAGTTACGGG-1	Enterocyte
GGGTTGCCAAACTGTC-1	Enterocyte
GGTATTGGTGTCTGAT-1	Enterocyte
GGTATTGTCGCCTGAG-1	Enterocyte
GGTGAAGAGAGTGACC-1	Enterocyte
GGTGAAGAGATGTTAG-1	Enterocyte
GGTGCGTAGCGAAGGG-1	Enterocyte
GGTGTTAGTTCGAATC-1	Enterocyte
GGTGTTATCATCGCTC-1	Enterocyte
GGTGTTATCGATGAGG-1	Enterocyte
GGTGTTATCTGCTGCT-1	Enterocyte
GTAACGTCACGCGAAA-1	Enterocyte
GTAACGTGTTCTCATT-1	Enterocyte
GTAACGTTCATCACCC-1	Enterocyte
GTAACTGCAGTGAGTG-1	Enterocyte
GTACGTACAAGGCTCC-1	Enterocyte
GTACTCCAGAATGTTG-1	Enterocyte
GTACTCCAGTGCAAGC-1	Enterocyte
GTACTCCGTAAACCTC-1	Enterocyte
GTACTCCGTTGTGGCC-1	Enterocyte
GTACTCCTCTCTTATG-1	Enterocyte
GTACTTTAGGTACTCT-1	Enterocyte
GTACTTTCAGACGTAG-1	Enterocyte
GTAGGCCCACCTCGGA-1	Enterocyte
GTAGGCCCAGCCTGTG-1	Enterocyte
GTAGGCCTCCTGCAGG-1	Enterocyte
GTAGTCAAGATCTGAA-1	Enterocyte
GTAGTCAGTCCAACTA-1	Enterocyte
GTAGTCATCTCATTCA-1	Enterocyte
GTAGTCATCTGCTTGC-1	Enterocyte
GTATCTTAGAAACCAT-1	Enterocyte
GTATCTTAGACGACGT-1	Enterocyte
GTATCTTAGATAGTCA-1	Enterocyte
GTATCTTAGATCCTGT-1	Enterocyte
GTATCTTCAAGTAATG-1	Enterocyte
GTATCTTGTTTGGCGC-1	Enterocyte
GTATCTTTCTGTTTGT-1	Enterocyte
GTATTCTAGATCACGG-1	Enterocyte
GTATTCTCAAGTTGTC-1	Enterocyte
GTCAAGTCAACTGCGC-1	Enterocyte
GTCAAGTCAAGCGATG-1	Enterocyte
GTCAAGTTCCAGGGCT-1	Enterocyte
GTCACGGAGATGTGGC-1	Enterocyte
GTCACGGAGCTGAAAT-1	Enterocyte
GTCACGGTCCCAGGTG-1	Enterocyte
GTCATTTAGGAATTAC-1	Enterocyte
GTCATTTAGTGCTGCC-1	Enterocyte
GTCATTTCAATGTTGC-1	Enterocyte
GTCATTTCAGCTCGAC-1	Enterocyte
GTCATTTCATGGTCAT-1	Enterocyte
GTCATTTGTCCGAGTC-1	Enterocyte
GTCATTTGTCCTGCTT-1	Enterocyte
GTCATTTGTGCCTGCA-1	Enterocyte
GTCATTTTCTTCGGTC-1	Enterocyte
GTCCTCAAGCTTTGGT-1	Enterocyte
GTCCTCACAATAGAGT-1	Enterocyte
GTCCTCATCAAACCGT-1	Enterocyte
GTCGTAAAGCAATCTC-1	Enterocyte
GTCGTAAAGGGATCTG-1	Enterocyte
GTCGTAACAATCGGTT-1	Enterocyte
GTCGTAACATGAGCGA-1	Enterocyte
GTCTCGTAGCGGCTTC-1	Enterocyte
GTCTCGTAGCTGTTCA-1	Enterocyte
GTCTCGTTCCTGCAGG-1	Enterocyte
GTCTTCGCAGCTGGCT-1	Enterocyte
GTCTTCGGTAGGGTAC-1	Enterocyte
GTCTTCGGTGGGTATG-1	Enterocyte
GTGAAGGGTCTGATCA-1	Enterocyte
GTGAAGGGTGTGTGCC-1	Enterocyte
GTGAAGGGTTTGACAC-1	Enterocyte
GTGAAGGTCTCTGCTG-1	Enterocyte
GTGCAGCAGCTACCGC-1	Enterocyte
GTGCAGCAGGCAATTA-1	Enterocyte
GTGCAGCGTTGGTAAA-1	Enterocyte
GTGCATAAGTTGTCGT-1	Enterocyte
GTGCATACATTAGGCT-1	Enterocyte
GTGCATACATTCGACA-1	Enterocyte
GTGCATAGTAGGGTAC-1	Enterocyte
GTGCATATCAGAGACG-1	Enterocyte
GTGCGGTAGTTCCACA-1	Enterocyte
GTGCGGTGTGATGTCT-1	Enterocyte
GTGCTTCAGACTGGGT-1	Enterocyte
GTGCTTCCACATCCAA-1	Enterocyte
GTGCTTCGTTCCCGAG-1	Enterocyte
GTGCTTCGTTTAGCTG-1	Enterocyte
GTGCTTCTCAACACAC-1	Enterocyte
GTGGGTCCACGGTGTC-1	Enterocyte
GTGGGTCCATCCTTGC-1	Enterocyte
GTGTTAGAGACTACAA-1	Enterocyte
GTGTTAGCAACACCTA-1	Enterocyte
GTGTTAGCAGACAAAT-1	Enterocyte
GTGTTAGGTGTTCTTT-1	Enterocyte
GTTACAGCACATCTTT-1	Enterocyte
GTTACAGCATCAGTAC-1	Enterocyte
GTTACAGGTATAGGTA-1	Enterocyte
GTTCATTAGAGCCCAA-1	Enterocyte
GTTCATTCATCGGACC-1	Enterocyte
GTTCATTTCAATAAGG-1	Enterocyte
GTTCATTTCTGTACGA-1	Enterocyte
GTTCGGGGTCAGGACA-1	Enterocyte
GTTCGGGTCATCACCC-1	Enterocyte
GTTCTCGTCCTCAACC-1	Enterocyte
GTTTCTATCTATGTGG-1	Enterocyte
TAAACCGCATTCTCAT-1	Enterocyte
TAAACCGGTGAGTATA-1	Enterocyte
TAAGAGAAGAAGAAGC-1	Enterocyte
TAAGAGACAAAGTGCG-1	Enterocyte
TAAGAGAGTGCTGTAT-1	Enterocyte
TAAGCGTGTCTGCCAG-1	Enterocyte
TAAGCGTTCACAGGCC-1	Enterocyte
TAAGTGCTCTAACCGA-1	Enterocyte
TACACGAGTCGGCTCA-1	Enterocyte
TACACGAGTTAAGAAC-1	Enterocyte
TACACGATCGCAGGCT-1	Enterocyte
TACAGTGGTTGGTAAA-1	Enterocyte
TACCTATAGCACAGGT-1	Enterocyte
TACCTATGTCTCTCTG-1	Enterocyte
TACCTATGTTAAGACA-1	Enterocyte
TACCTTAAGGCCGAAT-1	Enterocyte
TACCTTACACGCGAAA-1	Enterocyte
TACGGATAGACCCACC-1	Enterocyte
TACGGATCAATCGAAA-1	Enterocyte
TACGGGCAGTACTTGC-1	Enterocyte
TACGGGCGTATCACCA-1	Enterocyte
TACGGGCGTCTAGTGT-1	Enterocyte
TACGGTAGTAGCTTGT-1	Enterocyte
TACGGTAGTTCTGAAC-1	Enterocyte
TACGGTATCATACGGT-1	Enterocyte
TACGGTATCGATCCCT-1	Enterocyte
TACTCATGTACCGAGA-1	Enterocyte
TACTCATTCCCAGGTG-1	Enterocyte
TACTCGCCACCGCTAG-1	Enterocyte
TACTCGCCATTCGACA-1	Enterocyte
TACTCGCGTTCGCTAA-1	Enterocyte
TACTCGCTCCACGCAG-1	Enterocyte
TAGACCAAGCATGGCA-1	Enterocyte
TAGACCAAGGTTACCT-1	Enterocyte
TAGACCATCAACCATG-1	Enterocyte
TAGACCATCACTTACT-1	Enterocyte
TAGAGCTCACATTTCT-1	Enterocyte
TAGAGCTTCCGCATCT-1	Enterocyte
TAGAGCTTCGCCGTGA-1	Enterocyte
TAGAGCTTCTCACATT-1	Enterocyte
TAGCCGGAGCCGATTT-1	Enterocyte
TAGCCGGGTAACGTTC-1	Enterocyte
TAGCCGGTCAGTTGAC-1	Enterocyte
TAGGCATAGATGTGGC-1	Enterocyte
TAGGCATGTGTGTGCC-1	Enterocyte
TAGGCATTCGCGTTTC-1	Enterocyte
TAGTTGGCACCGTTGG-1	Enterocyte
TAGTTGGTCGTCGTTC-1	Enterocyte
TATCAGGAGCTTTGGT-1	Enterocyte
TATCAGGGTAGCACGA-1	Enterocyte
TATCTCAAGAAACCAT-1	Enterocyte
TATCTCAAGAGACTTA-1	Enterocyte
TATCTCACATCGGACC-1	Enterocyte
TATGCCCAGCCACGTC-1	Enterocyte
TATTACCAGATCACGG-1	Enterocyte
TATTACCAGCCAGGAT-1	Enterocyte
TATTACCCACCAGGCT-1	Enterocyte
TATTACCTCCGCAGTG-1	Enterocyte
TCAACGAAGACCTTTG-1	Enterocyte
TCAACGACATGGGACA-1	Enterocyte
TCAATCTCACCTTGTC-1	Enterocyte
TCAATCTGTCGACTAT-1	Enterocyte
TCACAAGAGTGCAAGC-1	Enterocyte
TCACAAGGTTGCGCAC-1	Enterocyte
TCACAAGTCCCTTGTG-1	Enterocyte
TCACGAACACGTTGGC-1	Enterocyte
TCAGATGAGTGTTTGC-1	Enterocyte
TCAGATGCAAAGCGGT-1	Enterocyte
TCAGATGCATCTCCCA-1	Enterocyte
TCAGATGGTTCCATGA-1	Enterocyte
TCAGCAAGTTCGCTAA-1	Enterocyte
TCAGCAATCAAGGTAA-1	Enterocyte
TCAGCAATCTCGTTTA-1	Enterocyte
TCAGCTCAGACAATAC-1	Enterocyte
TCAGCTCAGACATAAC-1	Enterocyte
TCAGCTCTCAATACCG-1	Enterocyte
TCAGCTCTCGTCACGG-1	Enterocyte
TCAGGATAGCGAAGGG-1	Enterocyte
TCAGGATTCACAATGC-1	Enterocyte
TCAGGTAGTAGATTAG-1	Enterocyte
TCAGGTATCATGCTCC-1	Enterocyte
TCAGGTATCGCTTAGA-1	Enterocyte
TCATTACAGACGCTTT-1	Enterocyte
TCATTACAGGATATAC-1	Enterocyte
TCATTACCACCTATCC-1	Enterocyte
TCATTACCAGTATCTG-1	Enterocyte
TCATTACGTATAAACG-1	Enterocyte
TCATTACGTTGGTGGA-1	Enterocyte
TCATTACTCTAACTCT-1	Enterocyte
TCATTACTCTAGAGTC-1	Enterocyte
TCATTTGAGGGTTTCT-1	Enterocyte
TCATTTGCACGCCAGT-1	Enterocyte
TCATTTGTCCACGCAG-1	Enterocyte
TCCACACAGCCCGAAA-1	Enterocyte
TCCCGATTCTGCTGCT-1	Enterocyte
TCCCGATTCTTAGCCC-1	Enterocyte
TCGAGGCAGGCCATAG-1	Enterocyte
TCGAGGCCAGATGGGT-1	Enterocyte
TCGAGGCGTTTACTCT-1	Enterocyte
TCGAGGCTCCGAATGT-1	Enterocyte
TCGCGAGCACTTACGA-1	Enterocyte
TCGCGTTAGATACACA-1	Enterocyte
TCGCGTTCAGTATGCT-1	Enterocyte
TCGCGTTGTCAACTGT-1	Enterocyte
TCGCGTTGTTCTGTTT-1	Enterocyte
TCGGGACAGCAACGGT-1	Enterocyte
TCGGGACCACAGAGGT-1	Enterocyte
TCGGGACGTTGGAGGT-1	Enterocyte
TCGGTAAAGACTAGGC-1	Enterocyte
TCGGTAACAACGATGG-1	Enterocyte
TCGGTAACACATTAGC-1	Enterocyte
TCGGTAATCGGAAACG-1	Enterocyte
TCGTACCCACAGGAGT-1	Enterocyte
TCGTACCCACAGGTTT-1	Enterocyte
TCGTACCCAGGACGTA-1	Enterocyte
TCGTACCTCTGTCCGT-1	Enterocyte
TCGTACCTCTTTCCTC-1	Enterocyte
TCGTAGACAGAGCCAA-1	Enterocyte
TCGTAGACATGTTCCC-1	Enterocyte
TCTATTGCAGCAGTTT-1	Enterocyte
TCTATTGCATACCATG-1	Enterocyte
TCTATTGGTAGCTCCG-1	Enterocyte
TCTATTGGTGTGACGA-1	Enterocyte
TCTCATAAGATCACGG-1	Enterocyte
TCTCTAACACCTCGTT-1	Enterocyte
TCTGAGAGTCAACATC-1	Enterocyte
TCTGAGAGTCTAAAGA-1	Enterocyte
TCTGGAACATGTAGTC-1	Enterocyte
TCTGGAAGTGGCTCCA-1	Enterocyte
TCTGGAATCACCCTCA-1	Enterocyte
TCTTCGGGTCATCGGC-1	Enterocyte
TCTTCGGTCCGTAGTA-1	Enterocyte
TCTTTCCAGGGTCTCC-1	Enterocyte
TCTTTCCGTAGCCTAT-1	Enterocyte
TCTTTCCTCCTGCCAT-1	Enterocyte
TCTTTCCTCGCGTTTC-1	Enterocyte
TCTTTCCTCGTACCGG-1	Enterocyte
TCTTTCCTCTGCGGCA-1	Enterocyte
TGAAAGAGTGCGCTTG-1	Enterocyte
TGAAAGATCGCGGATC-1	Enterocyte
TGACAACAGATTACCC-1	Enterocyte
TGACAACCACAACGTT-1	Enterocyte
TGACAACGTTAAGAAC-1	Enterocyte
TGACGGCAGAGGGCTT-1	Enterocyte
TGACGGCCAAGCCGCT-1	Enterocyte
TGACGGCCAAGTAGTA-1	Enterocyte
TGACGGCCACGACGAA-1	Enterocyte
TGACGGCCATAGTAAG-1	Enterocyte
TGACGGCGTTCCAACA-1	Enterocyte
TGACTAGAGAAGGTGA-1	Enterocyte
TGACTAGTCACCACCT-1	Enterocyte
TGACTTTGTGAAGGCT-1	Enterocyte
TGACTTTTCTAACCGA-1	Enterocyte
TGACTTTTCTGAGTGT-1	Enterocyte
TGAGAGGAGCAGATCG-1	Enterocyte
TGAGAGGAGCAGGCTA-1	Enterocyte
TGAGAGGAGGCGTACA-1	Enterocyte
TGAGAGGGTCCGAGTC-1	Enterocyte
TGAGAGGGTGCACCAC-1	Enterocyte
TGAGAGGTCAGTTAGC-1	Enterocyte
TGAGCATAGATGTGGC-1	Enterocyte
TGAGCATCATTTCACT-1	Enterocyte
TGAGCCGAGGAGTAGA-1	Enterocyte
TGAGCCGCAACTGGCC-1	Enterocyte
TGAGCCGCAGCTCCGA-1	Enterocyte
TGAGCCGGTATGCTTG-1	Enterocyte
TGAGCCGGTCTAGTGT-1	Enterocyte
TGAGCCGGTTACGGAG-1	Enterocyte
TGAGCCGTCTTCGGTC-1	Enterocyte
TGAGGGACACTGTGTA-1	Enterocyte
TGATTTCAGGAGCGAG-1	Enterocyte
TGATTTCTCCACTGGG-1	Enterocyte
TGATTTCTCCCTTGTG-1	Enterocyte
TGCCCATGTGAAAGAG-1	Enterocyte
TGCCCATTCATCTGCC-1	Enterocyte
TGCCCATTCCCTCTTT-1	Enterocyte
TGCCCATTCCGGCACA-1	Enterocyte
TGCCCATTCCGTAGTA-1	Enterocyte
TGCCCATTCGTTGACA-1	Enterocyte
TGCCCTACATTACGAC-1	Enterocyte
TGCCCTAGTGTTCGAT-1	Enterocyte
TGCCCTATCCTGCAGG-1	Enterocyte
TGCGCAGCACTTACGA-1	Enterocyte
TGCGCAGGTTCTGGTA-1	Enterocyte
TGCGCAGTCAGCATGT-1	Enterocyte
TGCGGGTTCGTCTGCT-1	Enterocyte
TGCGGGTTCGTTTGCC-1	Enterocyte
TGCGGGTTCTGATTCT-1	Enterocyte
TGCGTGGCAGTGGGAT-1	Enterocyte
TGCGTGGTCACATGCA-1	Enterocyte
TGCTACCAGCCGTCGT-1	Enterocyte
TGCTACCAGGATATAC-1	Enterocyte
TGCTACCAGTGGGCTA-1	Enterocyte
TGCTACCGTACATCCA-1	Enterocyte
TGCTACCTCATACGGT-1	Enterocyte
TGGACGCAGCCACGCT-1	Enterocyte
TGGACGCGTTATCACG-1	Enterocyte
TGGACGCTCCCTTGTG-1	Enterocyte
TGGCCAGAGGTTCCTA-1	Enterocyte
TGGCCAGAGTGTGAAT-1	Enterocyte
TGGCGCAAGGCTAGCA-1	Enterocyte
TGGCGCAGTAATCGTC-1	Enterocyte
TGGCGCAGTCGCGTGT-1	Enterocyte
TGGCGCATCGAGGTAG-1	Enterocyte
TGGCGCATCGCCATAA-1	Enterocyte
TGGCTGGAGAATGTGT-1	Enterocyte
TGGCTGGCAGTCAGAG-1	Enterocyte
TGGCTGGCATTTCAGG-1	Enterocyte
TGGCTGGTCCTTTACA-1	Enterocyte
TGGGAAGCAGGTCGTC-1	Enterocyte
TGGGAAGGTGGCGAAT-1	Enterocyte
TGGGAAGTCGGAGCAA-1	Enterocyte
TGGGCGTAGTCAAGGC-1	Enterocyte
TGGGCGTGTAGAAGGA-1	Enterocyte
TGGGCGTTCCACGTGG-1	Enterocyte
TGGTTAGCATACGCTA-1	Enterocyte
TGGTTAGTCGCTAGCG-1	Enterocyte
TGGTTCCAGGCTCAGA-1	Enterocyte
TGGTTCCGTGACGGTA-1	Enterocyte
TGTATTCAGAGCTTCT-1	Enterocyte
TGTATTCCAATCCAAC-1	Enterocyte
TGTATTCCATCTCGCT-1	Enterocyte
TGTCCCACATCCGTGG-1	Enterocyte
TGTCCCATCGGTCTAA-1	Enterocyte
TGTGGTAAGTGAAGAG-1	Enterocyte
TGTGTTTAGGTCATCT-1	Enterocyte
TGTGTTTGTCAAGCGA-1	Enterocyte
TGTTCCGCACAGCCCA-1	Enterocyte
TGTTCCGGTACGCACC-1	Enterocyte
TGTTCCGTCACCTTAT-1	Enterocyte
TGTTCCGTCCAGTATG-1	Enterocyte
TTAACTCAGAGTTGGC-1	Enterocyte
TTAACTCCAAGGACTG-1	Enterocyte
TTAACTCGTAAGGGCT-1	Enterocyte
TTAACTCTCTCAAGTG-1	Enterocyte
TTAGGACAGTACTTGC-1	Enterocyte
TTAGGACAGTGTCTCA-1	Enterocyte
TTAGGACCAAAGGCGT-1	Enterocyte
TTAGGACCAAGGTTTC-1	Enterocyte
TTAGGACTCTCCCTGA-1	Enterocyte
TTAGTTCGTCACCTAA-1	Enterocyte
TTAGTTCGTCTACCTC-1	Enterocyte
TTAGTTCGTCTGATTG-1	Enterocyte
TTAGTTCGTGGTGTAG-1	Enterocyte
TTAGTTCTCCTGCCAT-1	Enterocyte
TTAGTTCTCTTTAGTC-1	Enterocyte
TTATGCTTCATGTAGC-1	Enterocyte
TTCCCAGTCATCGGAT-1	Enterocyte
TTCGAAGCATGGTCAT-1	Enterocyte
TTCGGTCAGAAGGGTA-1	Enterocyte
TTCGGTCAGCGAAGGG-1	Enterocyte
TTCGGTCAGGGATCTG-1	Enterocyte
TTCGGTCCAGTCAGCC-1	Enterocyte
TTCTACAAGTTAGCGG-1	Enterocyte
TTCTACATCGGAGGTA-1	Enterocyte
TTCTACATCGTAGGTT-1	Enterocyte
TTCTCAAAGAACTGTA-1	Enterocyte
TTCTCAACAATGCCAT-1	Enterocyte
TTCTCAATCGTCCGTT-1	Enterocyte
TTCTCCTGTATGGTTC-1	Enterocyte
TTCTCCTGTCGCGGTT-1	Enterocyte
TTCTCCTTCGACGGAA-1	Enterocyte
TTCTCCTTCGGCGCAT-1	Enterocyte
TTCTTAGGTGATGTGG-1	Enterocyte
TTCTTAGTCGGTCTAA-1	Enterocyte
TTGAACGTCCGTTGTC-1	Enterocyte
TTGACTTCAAGAAGAG-1	Enterocyte
TTGACTTCAGACTCGC-1	Enterocyte
TTGACTTGTTACCGAT-1	Enterocyte
TTGACTTTCGAGCCCA-1	Enterocyte
TTGCCGTAGAGGACGG-1	Enterocyte
TTGCCGTCAGTCCTTC-1	Enterocyte
TTGCCGTTCCTCAACC-1	Enterocyte
TTGCGTCCAAACCTAC-1	Enterocyte
TTGCGTCTCGAGAGCA-1	Enterocyte
TTGGAACAGATCTGAA-1	Enterocyte
TTGGAACCAAACGTGG-1	Enterocyte
TTGGAACCAGATCGGA-1	Enterocyte
TTGGAACGTATATGAG-1	Enterocyte
TTGGAACGTCAACTGT-1	Enterocyte
TTGGAACTCCTTTCGG-1	Enterocyte
TTGGCAACAATGGACG-1	Enterocyte
TTGGCAAGTCAGTGGA-1	Enterocyte
TTGGCAATCGCGTAGC-1	Enterocyte
TTGTAGGAGGTGGGTT-1	Enterocyte
TTGTAGGCAGTAACGG-1	Enterocyte
TTGTAGGTCACCTTAT-1	Enterocyte
TTTACTGGTCTAGTGT-1	Enterocyte
TTTATGCAGCGCTCCA-1	Enterocyte
TTTATGCCATTTGCTT-1	Enterocyte
TTTATGCTCCCATTTA-1	Enterocyte
TTTGCGCAGATGAGAG-1	Enterocyte
TTTGCGCAGTATTGGA-1	Enterocyte
TTTGCGCGTATAGGTA-1	Enterocyte
TTTGCGCTCCGAACGC-1	Enterocyte
TTTGGTTCAGGAATGC-1	Enterocyte
TTTGGTTGTTCAGGCC-1	Enterocyte
TTTGTCAAGATCTGCT-1	Enterocyte
TTTGTCACACGTAAGG-1	Enterocyte
TTTGTCATCCGGGTGT-1	Enterocyte
AAACCTGAGGAGCGTT-1	Paneth
AAACCTGCAGCTGCTG-1	Paneth
AAACCTGTCACGCATA-1	Paneth
AAACGGGAGTGACATA-1	Paneth
AAACGGGCATGCCTTC-1	Paneth
AAACGGGGTGGCAAAC-1	Paneth
AAACGGGTCGGTCCGA-1	Paneth
AAAGATGAGTGGTCCC-1	Paneth
AAAGATGCAAAGGAAG-1	Paneth
AAAGATGTCAGGCCCA-1	Paneth
AAAGCAAAGGAATCGC-1	Paneth
AAAGCAACAGCCAGAA-1	Paneth
AAAGTAGCACATCCAA-1	Paneth
AAAGTAGGTTAAGAAC-1	Paneth
AAAGTAGTCAGGATCT-1	Paneth
AAATGCCAGACTAGAT-1	Paneth
AAATGCCAGAGGTTGC-1	Paneth
AAATGCCCAGACGTAG-1	Paneth
AAATGCCCAGCGATCC-1	Paneth
AAATGCCGTCCTGCTT-1	Paneth
AAATGCCGTGTTAAGA-1	Paneth
AAATGCCTCGATCCCT-1	Paneth
AACACGTAGAGTCTGG-1	Paneth
AACACGTCACGGCCAT-1	Paneth
AACACGTCATGGAATA-1	Paneth
AACACGTGTCAGTGGA-1	Paneth
AACACGTTCACGATGT-1	Paneth
AACACGTTCCGCGTTT-1	Paneth
AACCATGGTCATTAGC-1	Paneth
AACCATGGTGGTTTCA-1	Paneth
AACCGCGAGGTTACCT-1	Paneth
AACCGCGCACTGCCAG-1	Paneth
AACCGCGGTACCGTAT-1	Paneth
AACCGCGGTCAGAAGC-1	Paneth
AACCGCGGTGACGGTA-1	Paneth
AACGTTGAGCGTAATA-1	Paneth
AACGTTGGTCGAGATG-1	Paneth
AACTCAGCATCCAACA-1	Paneth
AACTCAGGTAGGACAC-1	Paneth
AACTCCCAGTGTCCAT-1	Paneth
AACTCCCCATTCCTCG-1	Paneth
AACTCCCGTACCATCA-1	Paneth
AACTCCCTCTCTAGGA-1	Paneth
AACTCTTAGAAGGTTT-1	Paneth
AACTCTTGTTTGTGTG-1	Paneth
AACTGGTCACCAGGTC-1	Paneth
AACTGGTCACCCTATC-1	Paneth
AACTGGTCATTGGGCC-1	Paneth
AACTGGTGTGCCTGTG-1	Paneth
AACTGGTGTTCCACAA-1	Paneth
AACTGGTTCGGACAAG-1	Paneth
AACTGGTTCTCAAGTG-1	Paneth
AACTTTCAGCGACGTA-1	Paneth
AACTTTCAGTGGAGAA-1	Paneth
AACTTTCTCCGGCACA-1	Paneth
AACTTTCTCGGACAAG-1	Paneth
AAGCCGCAGACAGACC-1	Paneth
AAGCCGCAGTCGTTTG-1	Paneth
AAGCCGCCACCAGGCT-1	Paneth
AAGCCGCGTCGACTGC-1	Paneth
AAGCCGCGTTACCGAT-1	Paneth
AAGCCGCGTTCTGTTT-1	Paneth
AAGCCGCTCCAATGGT-1	Paneth
AAGGAGCCAAGTCTAC-1	Paneth
AAGGAGCCACAACGTT-1	Paneth
AAGGAGCCAGTGACAG-1	Paneth
AAGGAGCGTAGTGAAT-1	Paneth
AAGGAGCGTCAAACTC-1	Paneth
AAGGAGCGTCCAAGTT-1	Paneth
AAGGAGCGTCCTCTTG-1	Paneth
AAGGAGCGTCTCTTTA-1	Paneth
AAGGAGCGTCTGATCA-1	Paneth
AAGGAGCTCCAGAAGG-1	Paneth
AAGGAGCTCCTAGTGA-1	Paneth
AAGGCAGCAGGGATTG-1	Paneth
AAGGCAGGTTAAGGGC-1	Paneth
AAGGCAGTCATGCATG-1	Paneth
AAGGCAGTCCATGAGT-1	Paneth
AAGGTTCCAATTGCTG-1	Paneth
AAGGTTCCACACGCTG-1	Paneth
AAGGTTCGTGACTCAT-1	Paneth
AAGGTTCTCTGAAAGA-1	Paneth
AAGTCTGTCAGGTTCA-1	Paneth
AAGTCTGTCCGCGCAA-1	Paneth
AAGTCTGTCTGATACG-1	Paneth
AATCCAGCAGAGCCAA-1	Paneth
AATCCAGCAGCTTCGG-1	Paneth
AATCCAGGTGGTCCGT-1	Paneth
AATCCAGTCTCCAACC-1	Paneth
AATCGGTCAGCCTTTC-1	Paneth
ACACCAACACCTCGGA-1	Paneth
ACACCAACACTGTTAG-1	Paneth
ACACCAATCACGATGT-1	Paneth
ACACCCTAGACTTGAA-1	Paneth
ACACCCTCACGAAAGC-1	Paneth
ACACCCTGTAAGGGAA-1	Paneth
ACACCCTTCACGAAGG-1	Paneth
ACACCGGCAAGCGAGT-1	Paneth
ACACCGGTCAAACCAC-1	Paneth
ACAGCCGAGCGTCTAT-1	Paneth
ACAGCCGAGTGAAGAG-1	Paneth
ACAGCCGCAAACAACA-1	Paneth
ACAGCCGCAGCGATCC-1	Paneth
ACAGCCGGTAGCTAAA-1	Paneth
ACAGCCGGTCTCCCTA-1	Paneth
ACAGCCGTCAACACAC-1	Paneth
ACAGCCGTCCAGTATG-1	Paneth
ACAGCCGTCTTGTCAT-1	Paneth
ACAGCTAAGGATGGAA-1	Paneth
ACAGCTACAGATCTGT-1	Paneth
ACAGCTACAGTGAGTG-1	Paneth
ACAGCTAGTCTGGTCG-1	Paneth
ACATACGGTCATGCAT-1	Paneth
ACATCAGTCTACTATC-1	Paneth
ACATGGTTCAACCATG-1	Paneth
ACATGGTTCGCAAGCC-1	Paneth
ACCAGTAAGAAACCTA-1	Paneth
ACCAGTACAATGGACG-1	Paneth
ACCAGTACATGCGCAC-1	Paneth
ACCAGTACATGTAGTC-1	Paneth
ACCAGTAGTAAAGGAG-1	Paneth
ACCAGTAGTGTGGCTC-1	Paneth
ACCAGTAGTGTGTGCC-1	Paneth
ACCAGTATCACCAGGC-1	Paneth
ACCAGTATCCAACCAA-1	Paneth
ACCCACTCAGGCTCAC-1	Paneth
ACCCACTCAGTTTACG-1	Paneth
ACCCACTTCGTAGATC-1	Paneth
ACCGTAACAAGGACTG-1	Paneth
ACCGTAACACGGTGTC-1	Paneth
ACCGTAACAGCATGAG-1	Paneth
ACCTTTAGTGCAACGA-1	Paneth
ACGAGCCCACACCGAC-1	Paneth
ACGAGCCTCCTGCAGG-1	Paneth
ACGAGCCTCTACTCAT-1	Paneth
ACGAGCCTCTTCGGTC-1	Paneth
ACGAGGAAGAACAACT-1	Paneth
ACGAGGAAGGCTATCT-1	Paneth
ACGAGGACACAAGTAA-1	Paneth
ACGAGGACAGTGAGTG-1	Paneth
ACGAGGAGTAGCGCAA-1	Paneth
ACGAGGAGTTCCGTCT-1	Paneth
ACGAGGATCACGACTA-1	Paneth
ACGATACGTCGACTAT-1	Paneth
ACGATACGTTTCGCTC-1	Paneth
ACGATACTCTCTTATG-1	Paneth
ACGATGTAGTGAAGAG-1	Paneth
ACGATGTCAAGACGTG-1	Paneth
ACGATGTGTCTAAAGA-1	Paneth
ACGATGTGTCTTCGTC-1	Paneth
ACGATGTGTGCCTGGT-1	Paneth
ACGATGTGTGCTAGCC-1	Paneth
ACGCAGCGTATAGGTA-1	Paneth
ACGCAGCGTTCTGTTT-1	Paneth
ACGCCAGCACCGGAAA-1	Paneth
ACGCCAGTCGAGCCCA-1	Paneth
ACGCCGAAGACTTGAA-1	Paneth
ACGCCGAGTAAGCACG-1	Paneth
ACGCCGATCGTGGGAA-1	Paneth
ACGGAGAAGGGATACC-1	Paneth
ACGGAGACAGGAATGC-1	Paneth
ACGGAGAGTGCGATAG-1	Paneth
ACGGAGATCGTGGACC-1	Paneth
ACGGCCAAGTAGGCCA-1	Paneth
ACGGCCACAATCCGAT-1	Paneth
ACGGCCACACGGTAAG-1	Paneth
ACGGCCAGTCCCGACA-1	Paneth
ACGGCCATCAAGAAGT-1	Paneth
ACGGCCATCCTATTCA-1	Paneth
ACGGGCTAGGCGACAT-1	Paneth
ACGGGCTCAAACGTGG-1	Paneth
ACGGGCTTCATCGGAT-1	Paneth
ACGGGTCAGGAGTACC-1	Paneth
ACGGGTCTCACTTACT-1	Paneth
ACGTCAAAGGGTTCCC-1	Paneth
ACGTCAACAGATGAGC-1	Paneth
ACGTCAACAGGGCATA-1	Paneth
ACGTCAAGTATCACCA-1	Paneth
ACGTCAAGTCAGAATA-1	Paneth
ACTATCTAGACTTGAA-1	Paneth
ACTATCTCAAGCGATG-1	Paneth
ACTATCTGTAGCTCCG-1	Paneth
ACTATCTTCACTTCAT-1	Paneth
ACTGAACAGTTACCCA-1	Paneth
ACTGAACCAAAGAATC-1	Paneth
ACTGAACCACCGATAT-1	Paneth
ACTGAACCAGGTGCCT-1	Paneth
ACTGAACGTCCGACGT-1	Paneth
ACTGAACGTGGTCTCG-1	Paneth
ACTGAACGTTGTGGCC-1	Paneth
ACTGAACTCAAAGACA-1	Paneth
ACTGAACTCATGTAGC-1	Paneth
ACTGAGTAGATATACG-1	Paneth
ACTGAGTAGTGATCGG-1	Paneth
ACTGAGTCAGATCTGT-1	Paneth
ACTGAGTCAGGACCCT-1	Paneth
ACTGAGTGTCATATCG-1	Paneth
ACTGAGTGTTCCACTC-1	Paneth
ACTGAGTGTTCTCATT-1	Paneth
ACTGAGTTCACATACG-1	Paneth
ACTGATGAGAGCCCAA-1	Paneth
ACTGATGGTATGAAAC-1	Paneth
ACTGCTCAGGATGGAA-1	Paneth
ACTGCTCCAGCTCGAC-1	Paneth
ACTGCTCCATGGTCTA-1	Paneth
ACTGCTCGTCAACATC-1	Paneth
ACTGCTCTCTGGAGCC-1	Paneth
ACTGTCCCAACACCCG-1	Paneth
ACTGTCCCAATGGAGC-1	Paneth
ACTGTCCCACTTCGAA-1	Paneth
ACTGTCCGTCTTTCAT-1	Paneth
ACTGTCCGTGCCTGGT-1	Paneth
ACTGTCCTCGCCTGAG-1	Paneth
ACTTACTGTTTGACTG-1	Paneth
ACTTGTTAGTACGACG-1	Paneth
ACTTGTTCAACTGCGC-1	Paneth
ACTTGTTGTATAAACG-1	Paneth
ACTTGTTGTTCAGGCC-1	Paneth
ACTTGTTGTTCCGGCA-1	Paneth
ACTTGTTTCATACGGT-1	Paneth
ACTTGTTTCCGTTGCT-1	Paneth
ACTTGTTTCGCTAGCG-1	Paneth
ACTTTCAAGCCAGTAG-1	Paneth
ACTTTCACAATACGCT-1	Paneth
ACTTTCAGTTCACCTC-1	Paneth
ACTTTCATCGATCCCT-1	Paneth
ACTTTCATCTCGTTTA-1	Paneth
AGAATAGCAGGGTATG-1	Paneth
AGAATAGCATTGGGCC-1	Paneth
AGAATAGCATTTCACT-1	Paneth
AGAATAGGTAGAAGGA-1	Paneth
AGAATAGGTGCTTCTC-1	Paneth
AGAATAGTCACTTACT-1	Paneth
AGACGTTAGGAATGGA-1	Paneth
AGACGTTCAATGGACG-1	Paneth
AGACGTTTCGCAGGCT-1	Paneth
AGAGCGAGTGTTGGGA-1	Paneth
AGAGCGATCACAGGCC-1	Paneth
AGAGCTTCAAACAACA-1	Paneth
AGAGTGGCAGTATCTG-1	Paneth
AGAGTGGGTAAAGTCA-1	Paneth
AGAGTGGGTACCGTAT-1	Paneth
AGAGTGGGTCACAAGG-1	Paneth
AGATCTGAGTCCTCCT-1	Paneth
AGATCTGCAAAGGTGC-1	Paneth
AGATCTGCAGACGCCT-1	Paneth
AGATTGCAGTGGGCTA-1	Paneth
AGATTGCTCAGAGGTG-1	Paneth
AGATTGCTCTGCGTAA-1	Paneth
AGCAGCCCAACTGGCC-1	Paneth
AGCAGCCGTACCGGCT-1	Paneth
AGCAGCCGTGAAGGCT-1	Paneth
AGCAGCCTCCTGCCAT-1	Paneth
AGCAGCCTCTCAAGTG-1	Paneth
AGCAGCCTCTTGCAAG-1	Paneth
AGCATACAGGGTGTTG-1	Paneth
AGCATACCAAGGACAC-1	Paneth
AGCATACTCAGTGTTG-1	Paneth
AGCATACTCAGTTGAC-1	Paneth
AGCATACTCGCCTGTT-1	Paneth
AGCCTAAAGCAGGCTA-1	Paneth
AGCCTAAGTCTAGTGT-1	Paneth
AGCCTAATCATCGGAT-1	Paneth
AGCGGTCAGGCGACAT-1	Paneth
AGCGGTCTCAACACGT-1	Paneth
AGCGGTCTCCATTCTA-1	Paneth
AGCGGTCTCGGCGCTA-1	Paneth
AGCGTATGTATAGGTA-1	Paneth
AGCGTATTCTGTACGA-1	Paneth
AGCGTCGGTCTTGATG-1	Paneth
AGCGTCGTCAGTCAGT-1	Paneth
AGCTCCTCAGAAGCAC-1	Paneth
AGCTCCTCATGTCGAT-1	Paneth
AGCTCCTTCCAATGGT-1	Paneth
AGCTCCTTCCCAAGTA-1	Paneth
AGCTCCTTCGTCTGCT-1	Paneth
AGCTCTCGTGATAAAC-1	Paneth
AGCTCTCTCGTTGCCT-1	Paneth
AGCTCTCTCTGAGGGA-1	Paneth
AGCTCTCTCTGGAGCC-1	Paneth
AGCTTGAAGAATCTCC-1	Paneth
AGCTTGATCAACGCTA-1	Paneth
AGCTTGATCGCACTCT-1	Paneth
AGGCCACAGCTGCGAA-1	Paneth
AGGCCACAGTTGAGTA-1	Paneth
AGGCCACCAGCTGTAT-1	Paneth
AGGCCACGTACTCGCG-1	Paneth
AGGCCACTCTTGTCAT-1	Paneth
AGGCCGTAGCTTATCG-1	Paneth
AGGCCGTAGGCCCTCA-1	Paneth
AGGCCGTCAATAGAGT-1	Paneth
AGGGAGTAGGGTTCCC-1	Paneth
AGGGAGTCAAGCCATT-1	Paneth
AGGGAGTCACGAAGCA-1	Paneth
AGGGAGTCACGGTTTA-1	Paneth
AGGGAGTTCGGTGTTA-1	Paneth
AGGGATGAGAAACCTA-1	Paneth
AGGGATGCAATGACCT-1	Paneth
AGGGTGAAGATGCGAC-1	Paneth
AGGGTGACACGGTTTA-1	Paneth
AGGGTGACAGAAGCAC-1	Paneth
AGGGTGACATGCCTTC-1	Paneth
AGGGTGATCCCGGATG-1	Paneth
AGGTCATTCCCAACGG-1	Paneth
AGGTCATTCTGCGACG-1	Paneth
AGGTCCGCATACGCTA-1	Paneth
AGGTCCGCATCGTCGG-1	Paneth
AGGTCCGTCTTGCATT-1	Paneth
AGTAGTCAGATCTGCT-1	Paneth
AGTAGTCCAAGTCTGT-1	Paneth
AGTAGTCCACAACTGT-1	Paneth
AGTAGTCTCACTTATC-1	Paneth
AGTAGTCTCTGTCCGT-1	Paneth
AGTCTTTCATACAGCT-1	Paneth
AGTCTTTGTATAATGG-1	Paneth
AGTCTTTTCGTGTAGT-1	Paneth
AGTGAGGAGTGACATA-1	Paneth
AGTGAGGCAGCGTTCG-1	Paneth
AGTGAGGTCTGTTTGT-1	Paneth
AGTGAGGTCTTTAGGG-1	Paneth
AGTGGGACAGGGTTAG-1	Paneth
AGTGGGAGTGATGCCC-1	Paneth
AGTGTCAAGTTTAGGA-1	Paneth
AGTGTCACAAAGAATC-1	Paneth
AGTGTCACATGCGCAC-1	Paneth
AGTGTCAGTCGGCATC-1	Paneth
AGTGTCAGTTCGAATC-1	Paneth
AGTTGGTCACATCCAA-1	Paneth
AGTTGGTCACCACGTG-1	Paneth
AGTTGGTCAGTTTACG-1	Paneth
AGTTGGTTCAGTTCGA-1	Paneth
AGTTGGTTCCTTTCGG-1	Paneth
ATAACGCAGAAACCGC-1	Paneth
ATAACGCAGCGATATA-1	Paneth
ATAACGCGTGCCTGTG-1	Paneth
ATAAGAGGTACAGTTC-1	Paneth
ATAAGAGGTATTAGCC-1	Paneth
ATAAGAGGTCAAAGCG-1	Paneth
ATAAGAGGTTCAGACT-1	Paneth
ATAAGAGGTTCCCGAG-1	Paneth
ATAAGAGTCTGGAGCC-1	Paneth
ATAGACCGTTTGTGTG-1	Paneth
ATAGACCTCGGTCTAA-1	Paneth
ATCACGACAATACGCT-1	Paneth
ATCACGACACTGAAGG-1	Paneth
ATCACGACAGACAAGC-1	Paneth
ATCACGACAGTTTACG-1	Paneth
ATCACGAGTGAAGGCT-1	Paneth
ATCACGATCCTTGACC-1	Paneth
ATCATCTAGCCCAATT-1	Paneth
ATCATCTCATCGATTG-1	Paneth
ATCATCTGTGCGATAG-1	Paneth
ATCATCTTCCGCGTTT-1	Paneth
ATCATGGAGCAATCTC-1	Paneth
ATCATGGAGCCCAGCT-1	Paneth
ATCATGGCAATTCCTT-1	Paneth
ATCATGGGTACAGTGG-1	Paneth
ATCATGGGTACTTCTT-1	Paneth
ATCATGGGTCACAAGG-1	Paneth
ATCATGGGTCTTTCAT-1	Paneth
ATCATGGTCAACCATG-1	Paneth
ATCATGGTCCTTTACA-1	Paneth
ATCATGGTCGGTCTAA-1	Paneth
ATCATGGTCTGGCGTG-1	Paneth
ATCCACCAGGAATCGC-1	Paneth
ATCCACCGTATTCGTG-1	Paneth
ATCCACCTCTGGGCCA-1	Paneth
ATCCGAAAGCAGGCTA-1	Paneth
ATCCGAAGTACATCCA-1	Paneth
ATCCGAAGTCGGCATC-1	Paneth
ATCGAGTAGGCAAAGA-1	Paneth
ATCGAGTCAAGAGGCT-1	Paneth
ATCGAGTTCAGCCTAA-1	Paneth
ATCTACTAGGTGCAAC-1	Paneth
ATCTACTCACAGGAGT-1	Paneth
ATCTACTGTAATCACC-1	Paneth
ATCTACTGTACCGCTG-1	Paneth
ATCTACTGTTCGTCTC-1	Paneth
ATCTGCCAGTCTCCTC-1	Paneth
ATCTGCCCAGCTGGCT-1	Paneth
ATCTGCCCAGTATAAG-1	Paneth
ATCTGCCGTGGCGAAT-1	Paneth
ATCTGCCTCATATCGG-1	Paneth
ATGAGGGCAATAGAGT-1	Paneth
ATGAGGGGTCTTTCAT-1	Paneth
ATGAGGGGTTTGTTGG-1	Paneth
ATGCGATAGTGACATA-1	Paneth
ATGCGATGTAGCGATG-1	Paneth
ATGCGATGTCGCATAT-1	Paneth
ATGCGATTCAGCGATT-1	Paneth
ATGGGAGAGATATACG-1	Paneth
ATGGGAGAGCGTGAAC-1	Paneth
ATGGGAGCAGGCAGTA-1	Paneth
ATGGGAGGTCATGCCG-1	Paneth
ATGGGAGGTGGGTCAA-1	Paneth
ATGGGAGGTTAAGGGC-1	Paneth
ATGGGAGTCAGCATGT-1	Paneth
ATGGGAGTCTGAGTGT-1	Paneth
ATGTGTGAGAAGGCCT-1	Paneth
ATGTGTGCAATGTAAG-1	Paneth
ATGTGTGGTCGCTTTC-1	Paneth
ATGTGTGGTCTAGAGG-1	Paneth
ATGTGTGTCGCAGGCT-1	Paneth
ATGTGTGTCTCTGTCG-1	Paneth
ATTACTCAGCCTTGAT-1	Paneth
ATTACTCAGCTCAACT-1	Paneth
ATTACTCAGGCATGTG-1	Paneth
ATTACTCAGGCTAGGT-1	Paneth
ATTACTCCAATGGAAT-1	Paneth
ATTACTCTCACCCTCA-1	Paneth
ATTATCCTCATCTGCC-1	Paneth
ATTATCCTCCAAGTAC-1	Paneth
ATTATCCTCTAGCACA-1	Paneth
ATTCTACCATGCTGGC-1	Paneth
ATTCTACTCATCGATG-1	Paneth
ATTCTACTCTTAACCT-1	Paneth
ATTGGACAGAATGTTG-1	Paneth
ATTGGACGTCTAGTCA-1	Paneth
ATTGGACTCATCGATG-1	Paneth
ATTGGACTCCCTCTTT-1	Paneth
ATTGGACTCGTCACGG-1	Paneth
ATTGGACTCTGCGTAA-1	Paneth
ATTGGACTCTGTTGAG-1	Paneth
ATTGGTGAGCACCGCT-1	Paneth
ATTGGTGGTCTCTCGT-1	Paneth
ATTGGTGGTGTGGTTT-1	Paneth
ATTGGTGTCGCGTAGC-1	Paneth
ATTTCTGTCTCCAACC-1	Paneth
ATTTCTGTCTCTAAGG-1	Paneth
CAACCAACAATGCCAT-1	Paneth
CAACCAACACAGCGTC-1	Paneth
CAACCAACATGTAGTC-1	Paneth
CAACCAAGTAAGTGGC-1	Paneth
CAACCAATCAACGGGA-1	Paneth
CAACCAATCACAGTAC-1	Paneth
CAACCAATCAGCTCTC-1	Paneth
CAACCTCAGGTGCACA-1	Paneth
CAACCTCTCGGAGGTA-1	Paneth
CAACCTCTCGTTACGA-1	Paneth
CAACCTCTCTGCCCTA-1	Paneth
CAACTAGAGTGCGATG-1	Paneth
CAACTAGCAAGGGTCA-1	Paneth
CAACTAGCATCGATTG-1	Paneth
CAACTAGGTACAGTTC-1	Paneth
CAAGAAACATACTCTT-1	Paneth
CAAGATCAGTGATCGG-1	Paneth
CAAGATCCAACCGCCA-1	Paneth
CAAGATCCACATTTCT-1	Paneth
CAAGATCCAGGAATGC-1	Paneth
CAAGGCCAGCAACGGT-1	Paneth
CAAGGCCAGCTGCGAA-1	Paneth
CAAGGCCAGGTGGGTT-1	Paneth
CAAGGCCCAACACGCC-1	Paneth
CAAGGCCCAAGAGGCT-1	Paneth
CAAGGCCCAAGTCTAC-1	Paneth
CAAGGCCGTATAATGG-1	Paneth
CAAGGCCGTCTAAAGA-1	Paneth
CACAAACAGCGAAGGG-1	Paneth
CACAAACGTGAGCGAT-1	Paneth
CACAAACGTTATCCGA-1	Paneth
CACAAACGTTCGGGCT-1	Paneth
CACACAAAGCGTTTAC-1	Paneth
CACACAAAGGCGACAT-1	Paneth
CACACAACAATCCGAT-1	Paneth
CACACAACAGCCTTTC-1	Paneth
CACACCTAGCTGAACG-1	Paneth
CACACCTAGGAGTCTG-1	Paneth
CACACCTCACAACTGT-1	Paneth
CACACCTCATCGACGC-1	Paneth
CACACCTGTACAGACG-1	Paneth
CACACCTGTAGCTGCC-1	Paneth
CACACCTGTCCGACGT-1	Paneth
CACACTCAGCCAGAAC-1	Paneth
CACACTCAGTTAAGTG-1	Paneth
CACACTCCACGTAAGG-1	Paneth
CACACTCCAGACGCTC-1	Paneth
CACACTCGTATAGGTA-1	Paneth
CACACTCGTCTAACGT-1	Paneth
CACAGGCAGACATAAC-1	Paneth
CACAGGCCACAAGTAA-1	Paneth
CACAGGCGTGACAAAT-1	Paneth
CACAGTAAGGAGTACC-1	Paneth
CACAGTACATACTCTT-1	Paneth
CACAGTAGTCCAGTAT-1	Paneth
CACAGTAGTTGTACAC-1	Paneth
CACATAGCAGTCGTGC-1	Paneth
CACATAGCAGTTCATG-1	Paneth
CACATAGGTGGCTCCA-1	Paneth
CACATAGTCTACCAGA-1	Paneth
CACATAGTCTTGAGAC-1	Paneth
CACATTTAGAGACTTA-1	Paneth
CACATTTCAATCCAAC-1	Paneth
CACATTTGTAGCGTGA-1	Paneth
CACATTTGTGGTGTAG-1	Paneth
CACATTTTCCACTCCA-1	Paneth
CACCACTAGAAGGGTA-1	Paneth
CACCACTAGACAGAGA-1	Paneth
CACCACTAGCGTGTCC-1	Paneth
CACCACTTCACGGTTA-1	Paneth
CACCACTTCATCGATG-1	Paneth
CACCAGGAGGATGGAA-1	Paneth
CACCAGGCAAAGGAAG-1	Paneth
CACCAGGCAATTCCTT-1	Paneth
CACCAGGCACCAGATT-1	Paneth
CACCAGGGTAGGAGTC-1	Paneth
CACCAGGGTATCAGTC-1	Paneth
CACCTTGAGACAAAGG-1	Paneth
CACCTTGAGATCCCAT-1	Paneth
CACCTTGAGTCCATAC-1	Paneth
CACCTTGCACAACGTT-1	Paneth
CACCTTGTCACGACTA-1	Paneth
CACCTTGTCGTACCGG-1	Paneth
CACTCCAAGCTAGGCA-1	Paneth
CACTCCAAGTCGAGTG-1	Paneth
CACTCCAGTCACCTAA-1	Paneth
CACTCCAGTCGAAAGC-1	Paneth
CACTCCAGTTGAGGTG-1	Paneth
CACTCCATCGAATGCT-1	Paneth
CAGAATCCACCTATCC-1	Paneth
CAGAATCCAGCCAATT-1	Paneth
CAGAATCCATAGACTC-1	Paneth
CAGAATCTCCACGCAG-1	Paneth
CAGAGAGAGACCTTTG-1	Paneth
CAGAGAGCAACCGCCA-1	Paneth
CAGAGAGCAAGTTAAG-1	Paneth
CAGAGAGTCAGCATGT-1	Paneth
CAGATCAGTCCCGACA-1	Paneth
CAGATCAGTGAGGCTA-1	Paneth
CAGATCATCCCGACTT-1	Paneth
CAGCAGCAGTCCGGTC-1	Paneth
CAGCAGCTCGCGGATC-1	Paneth
CAGCATAAGACATAAC-1	Paneth
CAGCATAAGATCCTGT-1	Paneth
CAGCATAAGGACAGAA-1	Paneth
CAGCATAAGGCGTACA-1	Paneth
CAGCATACAATCTACG-1	Paneth
CAGCATAGTAGCGTCC-1	Paneth
CAGCATAGTTTGCATG-1	Paneth
CAGCATATCAGCTCTC-1	Paneth
CAGCATATCTGGTGTA-1	Paneth
CAGCCGAAGAGCAATT-1	Paneth
CAGCCGAAGAGGACGG-1	Paneth
CAGCCGAAGATGTCGG-1	Paneth
CAGCCGACATTGGGCC-1	Paneth
CAGCCGAGTAGAGTGC-1	Paneth
CAGCCGAGTCCGAACC-1	Paneth
CAGCCGATCGCCGTGA-1	Paneth
CAGCGACCACGGTAAG-1	Paneth
CAGCGACCAGTTCATG-1	Paneth
CAGCGACGTAGCACGA-1	Paneth
CAGCGACTCTTGTTTG-1	Paneth
CAGCTAAAGGCACATG-1	Paneth
CAGCTAAAGGTGCAAC-1	Paneth
CAGCTAAAGTCGATAA-1	Paneth
CAGCTAAAGTGACATA-1	Paneth
CAGCTAAAGTGTGGCA-1	Paneth
CAGCTAAAGTTGTAGA-1	Paneth
CAGCTAAGTCACCCAG-1	Paneth
CAGCTAATCCAAATGC-1	Paneth
CAGCTGGCACAGACAG-1	Paneth
CAGCTGGGTGCTTCTC-1	Paneth
CAGCTGGTCTCTGAGA-1	Paneth
CAGCTGGTCTGTTTGT-1	Paneth
CAGGTGCAGCCCGAAA-1	Paneth
CAGGTGCCATTAACCG-1	Paneth
CAGGTGCGTTTACTCT-1	Paneth
CAGGTGCTCGCTTGTC-1	Paneth
CAGGTGCTCGGAATCT-1	Paneth
CAGGTGCTCTGTCCGT-1	Paneth
CAGGTGCTCTTGGGTA-1	Paneth
CAGTAACAGCAGCGTA-1	Paneth
CAGTAACAGCGTTGCC-1	Paneth
CAGTAACTCTTCGGTC-1	Paneth
CAGTCCTAGCTGATAA-1	Paneth
CAGTCCTGTATGCTTG-1	Paneth
CAGTCCTTCAACACCA-1	Paneth
CAGTCCTTCAACACGT-1	Paneth
CAGTCCTTCAGAGACG-1	Paneth
CAGTCCTTCCGCGCAA-1	Paneth
CAGTCCTTCGCATGAT-1	Paneth
CAGTCCTTCGGAAATA-1	Paneth
CATATGGTCTCCTATA-1	Paneth
CATATTCCAGCTGTTA-1	Paneth
CATATTCTCCCATTAT-1	Paneth
CATATTCTCGAATGGG-1	Paneth
CATCAAGCACGCTTTC-1	Paneth
CATCAAGGTAAGTGGC-1	Paneth
CATCAAGGTAGCGATG-1	Paneth
CATCAAGTCGAACTGT-1	Paneth
CATCAAGTCGGCCGAT-1	Paneth
CATCAGAAGAATAGGG-1	Paneth
CATCAGACATCACGAT-1	Paneth
CATCAGACATTGGTAC-1	Paneth
CATCAGATCAACGGGA-1	Paneth
CATCAGATCACTCTTA-1	Paneth
CATCAGATCATCATTC-1	Paneth
CATCAGATCCCAAGAT-1	Paneth
CATCCACAGTGACATA-1	Paneth
CATCCACCAACTGCGC-1	Paneth
CATCCACCAAGGTTCT-1	Paneth
CATCCACCACACAGAG-1	Paneth
CATCCACGTCATTAGC-1	Paneth
CATCCACTCCATGCTC-1	Paneth
CATCGAAAGGAATGGA-1	Paneth
CATCGAAGTACTTAGC-1	Paneth
CATCGAAGTCTCACCT-1	Paneth
CATCGGGGTAAGTGGC-1	Paneth
CATCGGGGTAGGGACT-1	Paneth
CATCGGGGTCAAACTC-1	Paneth
CATCGGGTCCGCGTTT-1	Paneth
CATCGGGTCGTAGATC-1	Paneth
CATGACAAGTGGCACA-1	Paneth
CATGACACAATAACGA-1	Paneth
CATGACATCGTAGATC-1	Paneth
CATGCCTCAGATGGCA-1	Paneth
CATGCCTGTACAGACG-1	Paneth
CATGCCTGTAGCGTAG-1	Paneth
CATGCCTGTGTCCTCT-1	Paneth
CATGCCTTCTCAAGTG-1	Paneth
CATGGCGAGAATAGGG-1	Paneth
CATGGCGTCCCTCTTT-1	Paneth
CATGGCGTCCGTTGTC-1	Paneth
CATTATCAGAATAGGG-1	Paneth
CATTATCAGGCGTACA-1	Paneth
CATTATCCACAGACTT-1	Paneth
CATTATCCACTTAACG-1	Paneth
CATTATCCAGCGTTCG-1	Paneth
CATTATCTCGGTCTAA-1	Paneth
CATTCGCAGACAGGCT-1	Paneth
CATTCGCGTATAAACG-1	Paneth
CCAATCCAGATTACCC-1	Paneth
CCAATCCAGGTACTCT-1	Paneth
CCAATCCCAAGTAATG-1	Paneth
CCAATCCCACGTAAGG-1	Paneth
CCAATCCCAGCATACT-1	Paneth
CCAATCCCATAGGATA-1	Paneth
CCAATCCGTTTGACTG-1	Paneth
CCAATCCTCGTCGTTC-1	Paneth
CCAATCCTCTGCTGCT-1	Paneth
CCACCTACACACATGT-1	Paneth
CCACCTACAGGATTGG-1	Paneth
CCACCTATCCTGCCAT-1	Paneth
CCACGGAAGAGCCCAA-1	Paneth
CCACGGAAGCAATATG-1	Paneth
CCACGGAAGCGTGAGT-1	Paneth
CCACGGACATTTCAGG-1	Paneth
CCACGGAGTAGCACGA-1	Paneth
CCACGGAGTTCAGGCC-1	Paneth
CCACTACAGTTGAGTA-1	Paneth
CCACTACCAGCGTTCG-1	Paneth
CCACTACGTCATCCCT-1	Paneth
CCACTACGTCCGAACC-1	Paneth
CCACTACTCCGATATG-1	Paneth
CCAGCGAAGTGGCACA-1	Paneth
CCAGCGAGTCAATACC-1	Paneth
CCAGCGAGTCTTCGTC-1	Paneth
CCAGCGAGTGCTCTTC-1	Paneth
CCATGTCCATAACCTG-1	Paneth
CCATGTCTCACCATAG-1	Paneth
CCATTCGAGAGGTTAT-1	Paneth
CCATTCGAGCGGATCA-1	Paneth
CCATTCGCAAAGGTGC-1	Paneth
CCATTCGCACGGATAG-1	Paneth
CCATTCGCACGTGAGA-1	Paneth
CCATTCGCATTGAGCT-1	Paneth
CCCAATCAGTACGTTC-1	Paneth
CCCAATCCACGCTTTC-1	Paneth
CCCAATCCACTCTGTC-1	Paneth
CCCAATCGTGTAAGTA-1	Paneth
CCCAGTTCACGTCTCT-1	Paneth
CCCAGTTTCTATCCCG-1	Paneth
CCCATACTCCCAAGTA-1	Paneth
CCCATACTCCTGTAGA-1	Paneth
CCCTCCTAGACTGTAA-1	Paneth
CCCTCCTCAAGAGTCG-1	Paneth
CCGGGATAGTCCGTAT-1	Paneth
CCGGGATAGTGTGGCA-1	Paneth
CCGGGATGTATCTGCA-1	Paneth
CCGGGATGTTCAGGCC-1	Paneth
CCGGGATGTTGCGCAC-1	Paneth
CCGGTAGAGGTCATCT-1	Paneth
CCGGTAGCACGAAATA-1	Paneth
CCGGTAGCACTAGTAC-1	Paneth
CCGGTAGGTCTAAAGA-1	Paneth
CCGGTAGGTCTGCGGT-1	Paneth
CCGGTAGTCTTGACGA-1	Paneth
CCGTACTAGAGGTTGC-1	Paneth
CCGTACTGTAAAGGAG-1	Paneth
CCGTACTTCCAGTAGT-1	Paneth
CCGTACTTCTGCAGTA-1	Paneth
CCGTGGACACAGATTC-1	Paneth
CCGTGGACACCACGTG-1	Paneth
CCGTGGACACCTTGTC-1	Paneth
CCGTGGAGTAAGCACG-1	Paneth
CCGTTCAGTCTCTTTA-1	Paneth
CCGTTCATCGCGTTTC-1	Paneth
CCTAAAGAGACAGGCT-1	Paneth
CCTAAAGAGAGCAATT-1	Paneth
CCTAAAGAGCCACTAT-1	Paneth
CCTAAAGAGTTAGCGG-1	Paneth
CCTAAAGAGTTAGGTA-1	Paneth
CCTAAAGGTGCCTGCA-1	Paneth
CCTAAAGTCGTGGGAA-1	Paneth
CCTAAAGTCTATCCCG-1	Paneth
CCTACACCACCCTATC-1	Paneth
CCTACACGTGAGCGAT-1	Paneth
CCTACACGTGTGCCTG-1	Paneth
CCTACACTCAACACCA-1	Paneth
CCTACACTCGAATCCA-1	Paneth
CCTACCAAGCGTCTAT-1	Paneth
CCTACCAAGTCGTTTG-1	Paneth
CCTACCACAAGACACG-1	Paneth
CCTAGCTAGGCTAGGT-1	Paneth
CCTAGCTCAACGCACC-1	Paneth
CCTAGCTCAATGCCAT-1	Paneth
CCTAGCTGTACCGCTG-1	Paneth
CCTAGCTGTAGGGACT-1	Paneth
CCTAGCTGTGCGATAG-1	Paneth
CCTAGCTTCCGCGGTA-1	Paneth
CCTATTACAGCATACT-1	Paneth
CCTATTACAGTTCCCT-1	Paneth
CCTATTAGTAATCACC-1	Paneth
CCTATTATCCTATTCA-1	Paneth
CCTCAGTAGCGTTCCG-1	Paneth
CCTCAGTAGGTGATTA-1	Paneth
CCTCAGTAGTTCCACA-1	Paneth
CCTCAGTCAGCTCGCA-1	Paneth
CCTCAGTGTACCGGCT-1	Paneth
CCTCAGTGTCTTCTCG-1	Paneth
CCTCAGTGTGTTGAGG-1	Paneth
CCTCAGTTCCTCTAGC-1	Paneth
CCTCTGAAGTGACTCT-1	Paneth
CCTCTGAGTACCGAGA-1	Paneth
CCTCTGAGTACTTAGC-1	Paneth
CCTCTGATCTGCTTGC-1	Paneth
CCTTACGCACCATCCT-1	Paneth
CCTTACGGTCCTCTTG-1	Paneth
CCTTACGTCACTTATC-1	Paneth
CCTTACGTCATACGGT-1	Paneth
CCTTCCCAGCTACCGC-1	Paneth
CCTTCCCCAAGCCCAC-1	Paneth
CCTTCGAAGAAGGGTA-1	Paneth
CCTTCGAAGGCGACAT-1	Paneth
CCTTCGATCAGCTCGG-1	Paneth
CCTTCGATCCACGCAG-1	Paneth
CCTTTCTCAGCCTTGG-1	Paneth
CCTTTCTGTCGGGTCT-1	Paneth
CCTTTCTTCTGGCGTG-1	Paneth
CGAACATAGACACTAA-1	Paneth
CGAACATAGCCTCGTG-1	Paneth
CGAACATAGTCCGTAT-1	Paneth
CGAACATCAACGCACC-1	Paneth
CGAACATGTCCAGTAT-1	Paneth
CGAATGTGTCTGCAAT-1	Paneth
CGAATGTTCTACTATC-1	Paneth
CGAATGTTCTATCCTA-1	Paneth
CGACCTTCAACGCACC-1	Paneth
CGACCTTGTCCCTTGT-1	Paneth
CGACCTTGTGCGGTAA-1	Paneth
CGACCTTGTGGCAAAC-1	Paneth
CGACTTCAGTGGCACA-1	Paneth
CGACTTCAGTTTGCGT-1	Paneth
CGACTTCCACAACTGT-1	Paneth
CGACTTCCAGTAAGCG-1	Paneth
CGACTTCGTCAAGCGA-1	Paneth
CGACTTCTCACAAACC-1	Paneth
CGACTTCTCTAGCACA-1	Paneth
CGAGAAGAGAGTTGGC-1	Paneth
CGAGAAGCACTTAAGC-1	Paneth
CGAGAAGGTTAAGACA-1	Paneth
CGAGAAGTCCCATTTA-1	Paneth
CGAGCACAGCAGGCTA-1	Paneth
CGAGCACAGGAGCGAG-1	Paneth
CGAGCACCAGCTATTG-1	Paneth
CGAGCACGTAAGTAGT-1	Paneth
CGAGCACTCTTTAGGG-1	Paneth
CGAGCCAAGCGTAATA-1	Paneth
CGAGCCAGTAGGCATG-1	Paneth
CGAGCCAGTGACGCCT-1	Paneth
CGAGCCAGTGACTCAT-1	Paneth
CGAGCCATCGTGGACC-1	Paneth
CGATCGGAGACACTAA-1	Paneth
CGATCGGAGATCACGG-1	Paneth
CGATCGGCAAACAACA-1	Paneth
CGATCGGCAGGCTGAA-1	Paneth
CGATCGGGTAATCACC-1	Paneth
CGATGGCCATACCATG-1	Paneth
CGATGTAAGATCCGAG-1	Paneth
CGATGTAAGCAGCCTC-1	Paneth
CGATTGAAGTGGGTTG-1	Paneth
CGATTGACACGTAAGG-1	Paneth
CGATTGACATACGCTA-1	Paneth
CGCCAAGCATGCCTAA-1	Paneth
CGCCAAGGTGTATGGG-1	Paneth
CGCCAAGGTGTGAATA-1	Paneth
CGCCAAGGTTCGTGAT-1	Paneth
CGCCAAGTCGCCTGTT-1	Paneth
CGCGGTAAGATCCCGC-1	Paneth
CGCGGTAAGCCTTGAT-1	Paneth
CGCGGTACATATACCG-1	Paneth
CGCGTTTAGATCCTGT-1	Paneth
CGCGTTTTCAGATAAG-1	Paneth
CGCTGGAGTGCAGGTA-1	Paneth
CGCTTCAAGGCGATAC-1	Paneth
CGCTTCAGTTCGTCTC-1	Paneth
CGCTTCAGTTGAGGTG-1	Paneth
CGCTTCAGTTGTGGCC-1	Paneth
CGGACACAGAACTGTA-1	Paneth
CGGACACAGCGTAATA-1	Paneth
CGGACACGTAGCTCCG-1	Paneth
CGGACACGTCCATGAT-1	Paneth
CGGACACTCGCCAAAT-1	Paneth
CGGACGTCATCGATGT-1	Paneth
CGGACGTCATCTCCCA-1	Paneth
CGGACGTTCATGTCCC-1	Paneth
CGGACTGAGCAGGCTA-1	Paneth
CGGACTGAGTAATCCC-1	Paneth
CGGACTGGTTCGGGCT-1	Paneth
CGGACTGTCTGTCTAT-1	Paneth
CGGAGCTAGAGGTAGA-1	Paneth
CGGAGCTAGGATGCGT-1	Paneth
CGGAGCTAGGCCGAAT-1	Paneth
CGGAGCTGTCAAGCGA-1	Paneth
CGGAGTCAGCAGGTCA-1	Paneth
CGGAGTCCACGTCTCT-1	Paneth
CGGAGTCCAGGAACGT-1	Paneth
CGGAGTCGTGTGGTTT-1	Paneth
CGGAGTCGTTATCACG-1	Paneth
CGGCTAGCACGACGAA-1	Paneth
CGGCTAGCAGTCAGCC-1	Paneth
CGGCTAGGTCATCGGC-1	Paneth
CGGCTAGGTTATCACG-1	Paneth
CGGGTCAAGGTGATAT-1	Paneth
CGGGTCACAGGCTGAA-1	Paneth
CGGGTCATCCCGACTT-1	Paneth
CGGGTCATCCTATGTT-1	Paneth
CGGTTAAGTCGACTGC-1	Paneth
CGTAGCGAGTCCTCCT-1	Paneth
CGTAGCGCAAGTAATG-1	Paneth
CGTAGGCAGTTGCAGG-1	Paneth
CGTAGGCCAACGCACC-1	Paneth
CGTAGGCCAATAGCAA-1	Paneth
CGTAGGCCAGGGAGAG-1	Paneth
CGTAGGCGTAAGGGCT-1	Paneth
CGTAGGCGTATAGTAG-1	Paneth
CGTAGGCGTCCGACGT-1	Paneth
CGTCACTGTTCCCTTG-1	Paneth
CGTCACTTCGTTGCCT-1	Paneth
CGTCACTTCTAGCACA-1	Paneth
CGTCAGGCAGCCAATT-1	Paneth
CGTCAGGCAGTACACT-1	Paneth
CGTCAGGTCATCATTC-1	Paneth
CGTCCATAGGCTAGGT-1	Paneth
CGTCCATAGTACGACG-1	Paneth
CGTCCATGTCGCTTTC-1	Paneth
CGTCTACAGCTGCGAA-1	Paneth
CGTCTACTCACAAACC-1	Paneth
CGTCTACTCACAGGCC-1	Paneth
CGTCTACTCTATCCCG-1	Paneth
CGTCTACTCTTGTTTG-1	Paneth
CGTGAGCAGGTGACCA-1	Paneth
CGTGAGCAGGTGGGTT-1	Paneth
CGTGAGCGTATGAAAC-1	Paneth
CGTGAGCTCTATCCTA-1	Paneth
CGTGAGCTCTGCAAGT-1	Paneth
CGTGTAAAGCCTCGTG-1	Paneth
CGTGTAACAGTCAGCC-1	Paneth
CGTGTAACATGCAATC-1	Paneth
CGTGTAAGTCTTGATG-1	Paneth
CGTGTAAGTGGGTCAA-1	Paneth
CGTGTAAGTTTGACAC-1	Paneth
CGTGTAATCAATCACG-1	Paneth
CGTGTAATCTCGTATT-1	Paneth
CGTGTCTAGTTAGCGG-1	Paneth
CGTGTCTGTCTAGTGT-1	Paneth
CGTGTCTGTTTACTCT-1	Paneth
CGTTAGACAATCACAC-1	Paneth
CGTTAGACACTGTCGG-1	Paneth
CGTTAGACAGTCGATT-1	Paneth
CGTTAGAGTGACTCAT-1	Paneth
CGTTCTGGTGTTCGAT-1	Paneth
CGTTCTGTCGCTTAGA-1	Paneth
CGTTGGGCAATGGTCT-1	Paneth
CGTTGGGCACGGCGTT-1	Paneth
CGTTGGGGTCGGCTCA-1	Paneth
CGTTGGGGTTGGTGGA-1	Paneth
CGTTGGGTCGAGAACG-1	Paneth
CTAACTTAGGAGTCTG-1	Paneth
CTAACTTAGTATGACA-1	Paneth
CTAACTTAGTGTACGG-1	Paneth
CTAACTTGTCATGCAT-1	Paneth
CTAACTTGTGATGCCC-1	Paneth
CTAACTTGTTCCCTTG-1	Paneth
CTAACTTTCACCTCGT-1	Paneth
CTAACTTTCCCTAACC-1	Paneth
CTAAGACCAGCCAATT-1	Paneth
CTACACCAGAAGCCCA-1	Paneth
CTACACCAGGAGTTGC-1	Paneth
CTACACCCAATAGCGG-1	Paneth
CTACATTAGCCCAATT-1	Paneth
CTACATTAGTACATGA-1	Paneth
CTACATTCAGTTAACC-1	Paneth
CTACATTCATGTAGTC-1	Paneth
CTACATTGTGTCCTCT-1	Paneth
CTACATTTCCTAAGTG-1	Paneth
CTACATTTCTCTTATG-1	Paneth
CTACATTTCTGGTTCC-1	Paneth
CTACCCACAAGTTAAG-1	Paneth
CTACCCATCCGTCAAA-1	Paneth
CTACGTCAGGTGATTA-1	Paneth
CTACGTCCAAGCGATG-1	Paneth
CTACGTCCACGAGGTA-1	Paneth
CTACGTCTCACCGTAA-1	Paneth
CTAGAGTGTGATGATA-1	Paneth
CTAGAGTTCAGGCAAG-1	Paneth
CTAGCCTCAATTGCTG-1	Paneth
CTAGCCTCATACCATG-1	Paneth
CTAGCCTGTAGGCATG-1	Paneth
CTAGCCTGTCCAGTAT-1	Paneth
CTAGCCTTCAAGGCTT-1	Paneth
CTAGCCTTCCGAACGC-1	Paneth
CTAGCCTTCTCTTATG-1	Paneth
CTAGTGAGTAGCGCAA-1	Paneth
CTAGTGAGTCAGCTAT-1	Paneth
CTAGTGAGTTGCTCCT-1	Paneth
CTAGTGAGTTGGTGGA-1	Paneth
CTCACACAGGGATACC-1	Paneth
CTCACACGTAAAGGAG-1	Paneth
CTCAGAAAGAACTGTA-1	Paneth
CTCAGAAAGACAGACC-1	Paneth
CTCAGAACATCTATGG-1	Paneth
CTCAGAACATTAGCCA-1	Paneth
CTCAGAATCAAACCGT-1	Paneth
CTCAGAATCGCTTAGA-1	Paneth
CTCATTACATCATCCC-1	Paneth
CTCCTAGCATTTGCTT-1	Paneth
CTCCTAGGTACGACCC-1	Paneth
CTCGAAACACAGCGTC-1	Paneth
CTCGAAAGTCAAAGCG-1	Paneth
CTCGAGGCAAGTTAAG-1	Paneth
CTCGAGGCACAGAGGT-1	Paneth
CTCGAGGCAGGATCGA-1	Paneth
CTCGAGGGTCTAGAGG-1	Paneth
CTCGAGGTCGCTGATA-1	Paneth
CTCGAGGTCTGTTTGT-1	Paneth
CTCGGAGCATCACGAT-1	Paneth
CTCGGAGTCCCTCAGT-1	Paneth
CTCGGGACAGGTCTCG-1	Paneth
CTCGGGAGTCGCGAAA-1	Paneth
CTCGGGAGTCTAGTGT-1	Paneth
CTCGGGAGTTGTACAC-1	Paneth
CTCGTACAGAGCTATA-1	Paneth
CTCGTACCACAAGCCC-1	Paneth
CTCGTACCACATGTGT-1	Paneth
CTCGTCAAGCAGCCTC-1	Paneth
CTCGTCACAGTAAGCG-1	Paneth
CTCGTCATCCATTCTA-1	Paneth
CTCTAATCAGCCTTGG-1	Paneth
CTCTAATGTCAGCTAT-1	Paneth
CTCTAATTCGCGTTTC-1	Paneth
CTCTAATTCTGCTGTC-1	Paneth
CTCTAATTCTGGTTCC-1	Paneth
CTCTACGCACGGTGTC-1	Paneth
CTCTGGTAGCGCTCCA-1	Paneth
CTCTGGTCAAGGACAC-1	Paneth
CTCTGGTGTAACGCGA-1	Paneth
CTCTGGTGTCAACTGT-1	Paneth
CTCTGGTGTCCAGTGC-1	Paneth
CTCTGGTTCACCAGGC-1	Paneth
CTCTGGTTCCGATATG-1	Paneth
CTGAAACAGTGAAGTT-1	Paneth
CTGAAACCAACTTGAC-1	Paneth
CTGAAACGTGCATCTA-1	Paneth
CTGAAGTCAGTAACGG-1	Paneth
CTGAAGTGTGTCCTCT-1	Paneth
CTGAAGTTCATCTGCC-1	Paneth
CTGATAGAGTCCGGTC-1	Paneth
CTGATAGCACTAGTAC-1	Paneth
CTGATAGGTAACGCGA-1	Paneth
CTGATAGTCTCGTATT-1	Paneth
CTGATCCAGTTCGCGC-1	Paneth
CTGATCCGTCCGAAGA-1	Paneth
CTGATCCTCCTATTCA-1	Paneth
CTGATCCTCGCACTCT-1	Paneth
CTGATCCTCGGTCCGA-1	Paneth
CTGATCCTCTGATTCT-1	Paneth
CTGCCTAAGAGGGATA-1	Paneth
CTGCCTATCGCGATCG-1	Paneth
CTGCGGAAGTGCAAGC-1	Paneth
CTGCGGACAATCCGAT-1	Paneth
CTGCGGAGTAAGTGTA-1	Paneth
CTGCGGAGTGGCTCCA-1	Paneth
CTGCGGATCAACGAAA-1	Paneth
CTGCGGATCTTGAGAC-1	Paneth
CTGCGGATCTTGTCAT-1	Paneth
CTGCTGTCAACCGCCA-1	Paneth
CTGCTGTCACATCCAA-1	Paneth
CTGCTGTGTATTAGCC-1	Paneth
CTGCTGTGTCCGAACC-1	Paneth
CTGGTCTCACGCATCG-1	Paneth
CTGGTCTCACGCGAAA-1	Paneth
CTGGTCTCAGTTCCCT-1	Paneth
CTGGTCTCATCACAAC-1	Paneth
CTGGTCTTCCCATTAT-1	Paneth
CTGGTCTTCCTTAATC-1	Paneth
CTGGTCTTCGCGTAGC-1	Paneth
CTGTGCTAGAGGACGG-1	Paneth
CTGTGCTAGATCCGAG-1	Paneth
CTGTGCTCAAGTACCT-1	Paneth
CTGTGCTCAAGTTGTC-1	Paneth
CTGTGCTCACATAACC-1	Paneth
CTGTGCTTCCCTTGCA-1	Paneth
CTGTTTACACGAAAGC-1	Paneth
CTGTTTAGTCTCGTTC-1	Paneth
CTGTTTAGTCTCTCTG-1	Paneth
CTGTTTAGTTGATTCG-1	Paneth
CTGTTTATCAATCTCT-1	Paneth
CTGTTTATCAGCAACT-1	Paneth
CTGTTTATCATCGATG-1	Paneth
CTGTTTATCCTACAGA-1	Paneth
CTGTTTATCTCGCTTG-1	Paneth
CTGTTTATCTCTTGAT-1	Paneth
CTTAACTGTAGGGTAC-1	Paneth
CTTACCGAGCGTGAGT-1	Paneth
CTTACCGGTCTTGTCC-1	Paneth
CTTAGGAAGAACTCGG-1	Paneth
CTTAGGAAGACTTTCG-1	Paneth
CTTAGGACAAACGCGA-1	Paneth
CTTCTCTAGGCGTACA-1	Paneth
CTTCTCTCAATGTAAG-1	Paneth
CTTCTCTCACAACTGT-1	Paneth
CTTCTCTGTAAGCACG-1	Paneth
CTTCTCTTCACGCGGT-1	Paneth
CTTGGCTAGATATACG-1	Paneth
CTTGGCTGTGTCGCTG-1	Paneth
CTTGGCTTCCTCATTA-1	Paneth
CTTGGCTTCGAATGGG-1	Paneth
CTTTGCGGTAGAAGGA-1	Paneth
CTTTGCGGTCCAAGTT-1	Paneth
GAAACTCCATGCCCGA-1	Paneth
GAAACTCTCAGGCAAG-1	Paneth
GAAACTCTCCTCTAGC-1	Paneth
GAAACTCTCGCGGATC-1	Paneth
GAAACTCTCGTGACAT-1	Paneth
GAAACTCTCTCGTATT-1	Paneth
GAAATGAAGGGCACTA-1	Paneth
GAAATGAAGTTCCACA-1	Paneth
GAAATGACAAGCCTAT-1	Paneth
GAAATGACATAGACTC-1	Paneth
GAAATGAGTAAAGTCA-1	Paneth
GAAATGAGTAATTGGA-1	Paneth
GAACATCCAGCGTCCA-1	Paneth
GAACATCGTGATAAAC-1	Paneth
GAACCTAAGGAGTACC-1	Paneth
GAACCTACAACGATCT-1	Paneth
GAACCTACATCCGGGT-1	Paneth
GAACCTAGTTCAGCGC-1	Paneth
GAACCTATCAGCAACT-1	Paneth
GAACCTATCAGTCAGT-1	Paneth
GAACCTATCTTGCCGT-1	Paneth
GAACGGACAATCAGAA-1	Paneth
GAACGGATCGGCGCAT-1	Paneth
GAAGCAGCAAAGGCGT-1	Paneth
GAAGCAGCAATCAGAA-1	Paneth
GAAGCAGCAGTGACAG-1	Paneth
GAAGCAGCATCCTAGA-1	Paneth
GAAGCAGTCAACGGGA-1	Paneth
GAAGCAGTCGTTTATC-1	Paneth
GAAGCAGTCTTCTGGC-1	Paneth
GAATAAGAGACTACAA-1	Paneth
GAATAAGAGTCCGGTC-1	Paneth
GAATAAGTCATAAAGG-1	Paneth
GAATAAGTCTACCTGC-1	Paneth
GAATGAACAGGAACGT-1	Paneth
GAATGAACATTTGCTT-1	Paneth
GAATGAATCAGAGACG-1	Paneth
GACACGCAGACCTAGG-1	Paneth
GACACGCGTAAATGTG-1	Paneth
GACACGCGTAGCAAAT-1	Paneth
GACACGCTCACCACCT-1	Paneth
GACACGCTCAGTCCCT-1	Paneth
GACAGAGCAAGCTGTT-1	Paneth
GACAGAGTCCAGAAGG-1	Paneth
GACAGAGTCCAGGGCT-1	Paneth
GACCAATCAATTGCTG-1	Paneth
GACCAATGTCCGTGAC-1	Paneth
GACCAATGTGATAAGT-1	Paneth
GACCAATTCTTCCTTC-1	Paneth
GACCTGGAGAAACGAG-1	Paneth
GACCTGGAGACGCACA-1	Paneth
GACCTGGAGACTAAGT-1	Paneth
GACCTGGAGACTTTCG-1	Paneth
GACCTGGAGCACACAG-1	Paneth
GACCTGGCATGATCCA-1	Paneth
GACCTGGGTATATGGA-1	Paneth
GACCTGGGTCGACTAT-1	Paneth
GACCTGGTCGCGGATC-1	Paneth
GACCTGGTCGGCCGAT-1	Paneth
GACGCGTAGCGTAGTG-1	Paneth
GACGCGTCATTGCGGC-1	Paneth
GACGCGTGTCAAAGCG-1	Paneth
GACGGCTAGGCTAGGT-1	Paneth
GACGGCTGTCACAAGG-1	Paneth
GACGGCTGTTCGGGCT-1	Paneth
GACGGCTTCAATAAGG-1	Paneth
GACGTGCAGCGATAGC-1	Paneth
GACGTGCAGGATGCGT-1	Paneth
GACGTGCAGTGCCATT-1	Paneth
GACGTTAAGCTTTGGT-1	Paneth
GACGTTAAGGCCATAG-1	Paneth
GACGTTACATGGTCTA-1	Paneth
GACGTTATCAGCTCTC-1	Paneth
GACTAACAGCTAACAA-1	Paneth
GACTAACAGGGTCGAT-1	Paneth
GACTAACAGTTAGGTA-1	Paneth
GACTAACGTAGCGTAG-1	Paneth
GACTAACGTGCACCAC-1	Paneth
GACTACAAGTTTGCGT-1	Paneth
GACTACACAGACAAGC-1	Paneth
GACTACACAGTAGAGC-1	Paneth
GACTACAGTGAGGGTT-1	Paneth
GACTACATCACGATGT-1	Paneth
GACTACATCTTTAGTC-1	Paneth
GACTGCGAGAGACGAA-1	Paneth
GACTGCGCACTGCCAG-1	Paneth
GACTGCGTCAAAGTAG-1	Paneth
GAGCAGACATAACCTG-1	Paneth
GAGCAGAGTACCATCA-1	Paneth
GAGCAGAGTCAGAAGC-1	Paneth
GAGCAGAGTCGCATCG-1	Paneth
GAGGTGACACCGGAAA-1	Paneth
GAGGTGACAGCGTAAG-1	Paneth
GAGGTGAGTGAGGCTA-1	Paneth
GAGGTGATCCAAACAC-1	Paneth
GAGTCCGCAATCCGAT-1	Paneth
GAGTCCGCAGTCAGCC-1	Paneth
GAGTCCGGTCTGCCAG-1	Paneth
GAGTCCGGTGGTCTCG-1	Paneth
GAGTCCGGTTTGGGCC-1	Paneth
GATCAGTAGCTCTCGG-1	Paneth
GATCAGTCACCGAAAG-1	Paneth
GATCAGTGTAAGAGGA-1	Paneth
GATCAGTGTAAGGATT-1	Paneth
GATCAGTTCAACGAAA-1	Paneth
GATCAGTTCTCTGAGA-1	Paneth
GATCGATAGGAGTTGC-1	Paneth
GATCGATAGGTGATTA-1	Paneth
GATCGATCAATCAGAA-1	Paneth
GATCGATGTATATGGA-1	Paneth
GATCGATGTCTGATTG-1	Paneth
GATCGATTCAGTTGAC-1	Paneth
GATCGATTCTCTAGGA-1	Paneth
GATCGCGGTAGCCTCG-1	Paneth
GATCGCGGTGGCAAAC-1	Paneth
GATCGCGTCAGGCCCA-1	Paneth
GATCGTAAGACTAGAT-1	Paneth
GATCGTACACGGTAAG-1	Paneth
GATCTAGCACTCAGGC-1	Paneth
GATCTAGCAGTTCATG-1	Paneth
GATCTAGGTTTGTTTC-1	Paneth
GATCTAGTCAAGAAGT-1	Paneth
GATCTAGTCTATCCCG-1	Paneth
GATCTAGTCTTCAACT-1	Paneth
GATGAAACATGGTTGT-1	Paneth
GATGAAAGTACGACCC-1	Paneth
GATGAAAGTCCAACTA-1	Paneth
GATGAAATCTCTAAGG-1	Paneth
GATGAGGAGATATGCA-1	Paneth
GATGAGGAGATCCTGT-1	Paneth
GATGAGGGTGTGGTTT-1	Paneth
GATGAGGTCAAGGCTT-1	Paneth
GATGAGGTCAAGGTAA-1	Paneth
GATGAGGTCCAGTATG-1	Paneth
GATGAGGTCTCAACTT-1	Paneth
GATGCTAAGGCATGGT-1	Paneth
GATGCTAGTCGCGAAA-1	Paneth
GATTCAGGTACAGTTC-1	Paneth
GATTCAGGTTGGGACA-1	Paneth
GCAAACTCAATGGAAT-1	Paneth
GCAAACTCACAGCCCA-1	Paneth
GCAAACTCACTTAAGC-1	Paneth
GCAAACTCAGCTCGAC-1	Paneth
GCAAACTGTACTCTCC-1	Paneth
GCAAACTTCACCACCT-1	Paneth
GCAATCACACAACGTT-1	Paneth
GCAATCATCCGTTGCT-1	Paneth
GCAATCATCTAAGCCA-1	Paneth
GCACATAAGAAGAAGC-1	Paneth
GCACATAAGACTTTCG-1	Paneth
GCACTCTAGGTCATCT-1	Paneth
GCACTCTGTATAGGGC-1	Paneth
GCACTCTGTGGACGAT-1	Paneth
GCAGCCAGTTAGGGTG-1	Paneth
GCAGCCAGTTCTGTTT-1	Paneth
GCAGTTAGTAGCCTCG-1	Paneth
GCAGTTATCCGAACGC-1	Paneth
GCATACAAGGACACCA-1	Paneth
GCATACACATACTACG-1	Paneth
GCATACATCGTAGGTT-1	Paneth
GCATACATCTACTCAT-1	Paneth
GCATGATAGGCCATAG-1	Paneth
GCATGATCAATGAATG-1	Paneth
GCATGATCATCGACGC-1	Paneth
GCATGATGTCCAACTA-1	Paneth
GCATGTACACACTGCG-1	Paneth
GCATGTACATTGAGCT-1	Paneth
GCATGTAGTCGATTGT-1	Paneth
GCCAAATCAATCGAAA-1	Paneth
GCCAAATCATGGTCAT-1	Paneth
GCCTCTAAGATCGATA-1	Paneth
GCCTCTACAAGCCGTC-1	Paneth
GCCTCTACAGTTTACG-1	Paneth
GCCTCTAGTCACTGGC-1	Paneth
GCCTCTAGTCGGCTCA-1	Paneth
GCCTCTATCGCGTAGC-1	Paneth
GCGACCAAGTGGCACA-1	Paneth
GCGACCAGTAGCCTCG-1	Paneth
GCGACCAGTTCCACAA-1	Paneth
GCGAGAAAGGCGATAC-1	Paneth
GCGAGAACATAGGATA-1	Paneth
GCGAGAAGTACCGAGA-1	Paneth
GCGAGAATCCTCTAGC-1	Paneth
GCGCAACCAGTAACGG-1	Paneth
GCGCAGTAGGAGTTGC-1	Paneth
GCGCAGTCAAGCTGTT-1	Paneth
GCGCAGTTCCGCGTTT-1	Paneth
GCGCCAAAGTGTGGCA-1	Paneth
GCGCCAACACCTGGTG-1	Paneth
GCGCCAAGTAAGTGGC-1	Paneth
GCGCCAAGTATCGCAT-1	Paneth
GCGCCAATCGAACTGT-1	Paneth
GCGCGATCAAGAGGCT-1	Paneth
GCGCGATCACCGAAAG-1	Paneth
GCGCGATCACGCGAAA-1	Paneth
GCGCGATCACGTTGGC-1	Paneth
GCGCGATCAGCTGTAT-1	Paneth
GCGCGATGTACCGTAT-1	Paneth
GCGCGATTCTATGTGG-1	Paneth
GCGGGTTCAACTGGCC-1	Paneth
GCGGGTTCAGCGTTCG-1	Paneth
GCGGGTTCAGGGTATG-1	Paneth
GCGGGTTCATATGCTG-1	Paneth
GCGGGTTCATTGCGGC-1	Paneth
GCGGGTTGTGGGTATG-1	Paneth
GCGGGTTTCACTCTTA-1	Paneth
GCGGGTTTCAGCTTAG-1	Paneth
GCTCTGTCAAATCCGT-1	Paneth
GCTCTGTTCCCATTTA-1	Paneth
GCTGCAGAGTCATGCT-1	Paneth
GCTGCAGCACTATCTT-1	Paneth
GCTGCAGTCTTGTATC-1	Paneth
GCTGCGACACGTCAGC-1	Paneth
GCTGCGAGTTGATTGC-1	Paneth
GCTGCGATCCAGGGCT-1	Paneth
GCTGCTTAGAAACCGC-1	Paneth
GCTGCTTCAGTTCATG-1	Paneth
GCTGCTTGTCAAACTC-1	Paneth
GCTGCTTGTGTTCTTT-1	Paneth
GCTGGGTCAGCATACT-1	Paneth
GCTGGGTCATGATCCA-1	Paneth
GCTGGGTTCTCGATGA-1	Paneth
GCTTCCAAGGACAGCT-1	Paneth
GCTTCCAGTAGAAAGG-1	Paneth
GCTTCCAGTCTCTCGT-1	Paneth
GCTTGAAAGGGTCGAT-1	Paneth
GCTTGAAGTACGCACC-1	Paneth
GCTTGAAGTCGCTTTC-1	Paneth
GCTTGAATCGGAAACG-1	Paneth
GCTTGAATCGGTGTTA-1	Paneth
GGAAAGCAGCTGGAAC-1	Paneth
GGAAAGCCATTAACCG-1	Paneth
GGAACTTAGCTCCTTC-1	Paneth
GGAACTTAGGTAGCTG-1	Paneth
GGAATAAAGAATTCCC-1	Paneth
GGAATAACAAGCTGAG-1	Paneth
GGAATAACATCACAAC-1	Paneth
GGAATAATCCAGATCA-1	Paneth
GGAATAATCTGTCAAG-1	Paneth
GGACAAGCAACAACCT-1	Paneth
GGACAAGCAGTGGAGT-1	Paneth
GGACAAGCATAGAAAC-1	Paneth
GGACAAGTCACTCCTG-1	Paneth
GGACAAGTCCTGTACC-1	Paneth
GGACAAGTCGTTACGA-1	Paneth
GGACAAGTCTCTGAGA-1	Paneth
GGACAAGTCTGCGGCA-1	Paneth
GGACAGAAGTGGTAGC-1	Paneth
GGACAGATCCAGATCA-1	Paneth
GGACATTAGACAGGCT-1	Paneth
GGACATTAGAGATGAG-1	Paneth
GGACATTAGGATGTAT-1	Paneth
GGACATTCACTAGTAC-1	Paneth
GGACATTGTACCGCTG-1	Paneth
GGACATTTCCCATTTA-1	Paneth
GGACATTTCTCACATT-1	Paneth
GGACATTTCTGGTATG-1	Paneth
GGACGTCCAGATGGGT-1	Paneth
GGACGTCGTTCCGGCA-1	Paneth
GGACGTCTCTGGAGCC-1	Paneth
GGAGCAAAGTGGACGT-1	Paneth
GGAGCAACATCCGCGA-1	Paneth
GGAGCAATCCTTGCCA-1	Paneth
GGATGTTAGTTCGCAT-1	Paneth
GGATGTTGTAGGACAC-1	Paneth
GGATGTTGTTGGAGGT-1	Paneth
GGATGTTTCACCGGGT-1	Paneth
GGATGTTTCTGGTTCC-1	Paneth
GGATGTTTCTTCCTTC-1	Paneth
GGATTACAGTGGAGAA-1	Paneth
GGATTACCAGCTTAAC-1	Paneth
GGATTACTCTTCAACT-1	Paneth
GGCAATTAGGCAGGTT-1	Paneth
GGCAATTAGTGTACGG-1	Paneth
GGCCGATAGGACACCA-1	Paneth
GGCCGATCAAGGCTCC-1	Paneth
GGCCGATCAGTATAAG-1	Paneth
GGCCGATTCATGCTCC-1	Paneth
GGCGACTAGGCCCGTT-1	Paneth
GGCGACTAGGGTGTTG-1	Paneth
GGCGACTCACGAGGTA-1	Paneth
GGCGTGTAGCTAGTTC-1	Paneth
GGCGTGTAGCTCTCGG-1	Paneth
GGCGTGTAGTACCGGA-1	Paneth
GGCGTGTCAGTTCATG-1	Paneth
GGCGTGTTCGCTGATA-1	Paneth
GGCTCGAAGGTGGGTT-1	Paneth
GGCTCGAAGTGGGCTA-1	Paneth
GGCTCGAGTCGCGTGT-1	Paneth
GGCTCGAGTTTGCATG-1	Paneth
GGCTCGATCCAAGCCG-1	Paneth
GGCTCGATCCTTTCTC-1	Paneth
GGCTGGTAGGACGAAA-1	Paneth
GGCTGGTCAAGCGATG-1	Paneth
GGCTGGTCACCAGATT-1	Paneth
GGCTGGTTCAACTCTT-1	Paneth
GGCTGGTTCGAACTGT-1	Paneth
GGGAATGAGCCACGCT-1	Paneth
GGGAATGGTAGCTCCG-1	Paneth
GGGAATGGTGTGAATA-1	Paneth
GGGAATGTCCCAAGTA-1	Paneth
GGGAATGTCCTGCTTG-1	Paneth
GGGAATGTCTAACTTC-1	Paneth
GGGACCTAGGCTAGGT-1	Paneth
GGGACCTCACATTAGC-1	Paneth
GGGACCTTCATCGCTC-1	Paneth
GGGATGACAGGCTCAC-1	Paneth
GGGATGAGTTGAGTTC-1	Paneth
GGGATGATCGCGTTTC-1	Paneth
GGGCACTCAAGTACCT-1	Paneth
GGGCACTCAGCTCGAC-1	Paneth
GGGCACTGTCACAAGG-1	Paneth
GGGCACTGTGATGATA-1	Paneth
GGGCACTTCATCGGAT-1	Paneth
GGGCACTTCTATGTGG-1	Paneth
GGGCATCAGCGGATCA-1	Paneth
GGGCATCAGTCCGTAT-1	Paneth
GGGTCTGCAGTAACGG-1	Paneth
GGGTTGCAGTAGTGCG-1	Paneth
GGGTTGCGTGAGGGAG-1	Paneth
GGGTTGCTCAGCACAT-1	Paneth
GGTATTGAGGTGCAAC-1	Paneth
GGTATTGCAGCCACCA-1	Paneth
GGTATTGGTGACGCCT-1	Paneth
GGTGAAGCATGCCTTC-1	Paneth
GGTGAAGCATGGTAGG-1	Paneth
GGTGCGTAGATGCGAC-1	Paneth
GGTGCGTAGGGTGTGT-1	Paneth
GGTGCGTAGTAGCGGT-1	Paneth
GGTGCGTTCGCAGGCT-1	Paneth
GGTGTTAAGACGCACA-1	Paneth
GGTGTTAAGAGACTTA-1	Paneth
GGTGTTAGTGGCGAAT-1	Paneth
GGTGTTATCAGGTTCA-1	Paneth
GGTGTTATCCTCAATT-1	Paneth
GGTGTTATCGGAATCT-1	Paneth
GTAACGTAGATCCCAT-1	Paneth
GTAACGTCAGCTGGCT-1	Paneth
GTAACTGCACAACTGT-1	Paneth
GTAACTGCACATAACC-1	Paneth
GTAACTGCACTTAAGC-1	Paneth
GTAACTGGTCAAACTC-1	Paneth
GTAACTGGTTACCGAT-1	Paneth
GTAACTGGTTGGGACA-1	Paneth
GTACGTAAGACTTGAA-1	Paneth
GTACGTAAGGCAGGTT-1	Paneth
GTACGTAAGTGCCATT-1	Paneth
GTACGTACAACGATCT-1	Paneth
GTACGTACACAACGTT-1	Paneth
GTACGTACAGCTGTGC-1	Paneth
GTACTCCAGAAGAAGC-1	Paneth
GTACTCCAGGAGTCTG-1	Paneth
GTACTCCAGTACGACG-1	Paneth
GTACTCCCACCGTTGG-1	Paneth
GTACTCCTCTGCCAGG-1	Paneth
GTACTTTAGAGCTGGT-1	Paneth
GTACTTTGTAGCTAAA-1	Paneth
GTACTTTGTCACTTCC-1	Paneth
GTAGGCCAGCGATCCC-1	Paneth
GTAGGCCAGCTGCCCA-1	Paneth
GTAGGCCCATGTCGAT-1	Paneth
GTAGTCACAGCTGTGC-1	Paneth
GTATCTTCAAGCCCAC-1	Paneth
GTATCTTCACTTGGAT-1	Paneth
GTATCTTGTCTTGCGG-1	Paneth
GTATCTTGTTGGGACA-1	Paneth
GTATCTTTCTTACCGC-1	Paneth
GTATCTTTCTTCAACT-1	Paneth
GTATTCTAGACTAGGC-1	Paneth
GTATTCTAGCTAGTCT-1	Paneth
GTATTCTTCCAATGGT-1	Paneth
GTATTCTTCCTATTCA-1	Paneth
GTCAAGTAGTGTGGCA-1	Paneth
GTCAAGTCAGCTTAAC-1	Paneth
GTCAAGTGTTTAGGAA-1	Paneth
GTCACAACATTAGGCT-1	Paneth
GTCACAATCAAGGTAA-1	Paneth
GTCACAATCCAAGCCG-1	Paneth
GTCACAATCGTTTGCC-1	Paneth
GTCACGGAGTTGTAGA-1	Paneth
GTCACGGGTACTTCTT-1	Paneth
GTCACGGTCAGCTGGC-1	Paneth
GTCACGGTCCAAGTAC-1	Paneth
GTCACGGTCTCTGCTG-1	Paneth
GTCACGGTCTCTGTCG-1	Paneth
GTCATTTCATCGGAAG-1	Paneth
GTCATTTTCAACACTG-1	Paneth
GTCCTCACATATGGTC-1	Paneth
GTCCTCAGTTTGTGTG-1	Paneth
GTCCTCATCTGCAAGT-1	Paneth
GTCGGGTAGAAGGTTT-1	Paneth
GTCGGGTAGTCGAGTG-1	Paneth
GTCGGGTCAAGGTTCT-1	Paneth
GTCGGGTGTCTGGTCG-1	Paneth
GTCGTAAAGCGTTTAC-1	Paneth
GTCGTAATCGTAGGAG-1	Paneth
GTCTCGTAGAGCTTCT-1	Paneth
GTCTCGTCAAGCTGAG-1	Paneth
GTCTCGTCACCAGTTA-1	Paneth
GTCTCGTCATGCTGGC-1	Paneth
GTCTCGTTCGCCATAA-1	Paneth
GTGAAGGAGGGCACTA-1	Paneth
GTGAAGGGTACGCACC-1	Paneth
GTGAAGGGTATGCTTG-1	Paneth
GTGAAGGTCGGCCGAT-1	Paneth
GTGCAGCAGTACATGA-1	Paneth
GTGCAGCCAGTGGAGT-1	Paneth
GTGCAGCCATTTCACT-1	Paneth
GTGCAGCTCATCGATG-1	Paneth
GTGCATAAGGCTAGAC-1	Paneth
GTGCATAGTATGGTTC-1	Paneth
GTGCATATCACCAGGC-1	Paneth
GTGCATATCAGTTTGG-1	Paneth
GTGCGGTAGACAAGCC-1	Paneth
GTGCGGTAGGGAGTAA-1	Paneth
GTGCGGTGTCGACTGC-1	Paneth
GTGCTTCAGCTAGTGG-1	Paneth
GTGCTTCCACAGCCCA-1	Paneth
GTGCTTCCAGCCTATA-1	Paneth
GTGCTTCGTCGGCACT-1	Paneth
GTGGGTCAGAAACCTA-1	Paneth
GTGGGTCCATCCCATC-1	Paneth
GTGGGTCCATTCGACA-1	Paneth
GTGTGCGAGGATTCGG-1	Paneth
GTGTTAGCAATGAAAC-1	Paneth
GTGTTAGCATGTAAGA-1	Paneth
GTTAAGCCATCTCGCT-1	Paneth
GTTAAGCGTTACGTCA-1	Paneth
GTTAAGCGTTCAGCGC-1	Paneth
GTTAAGCTCCTACAGA-1	Paneth
GTTACAGAGCCACCTG-1	Paneth
GTTACAGAGCGTGTCC-1	Paneth
GTTACAGTCGAGCCCA-1	Paneth
GTTCATTAGGTTCCTA-1	Paneth
GTTCATTCACAACTGT-1	Paneth
GTTCATTGTAGCTGCC-1	Paneth
GTTCATTGTCCAGTGC-1	Paneth
GTTCATTTCCATTCTA-1	Paneth
GTTCATTTCTTCGGTC-1	Paneth
GTTCGGGAGCGTAGTG-1	Paneth
GTTCGGGAGGCGACAT-1	Paneth
GTTCGGGAGTACGCGA-1	Paneth
GTTCGGGCAGCTATTG-1	Paneth
GTTCGGGGTCCTCTTG-1	Paneth
GTTCGGGGTGAGTGAC-1	Paneth
GTTCGGGGTTGGACCC-1	Paneth
GTTCGGGTCTTACCGC-1	Paneth
GTTCTCGAGCTTATCG-1	Paneth
GTTCTCGAGGGTCGAT-1	Paneth
GTTCTCGCAATGGTCT-1	Paneth
GTTTCTAAGATGTGTA-1	Paneth
GTTTCTAAGTGTCCAT-1	Paneth
GTTTCTACAAAGCAAT-1	Paneth
GTTTCTACATTCACTT-1	Paneth
TAAACCGCATGCAATC-1	Paneth
TAAACCGGTAAACGCG-1	Paneth
TAAACCGGTAGAAAGG-1	Paneth
TAAACCGGTGGTTTCA-1	Paneth
TAAACCGTCAAGCCTA-1	Paneth
TAAACCGTCGCACTCT-1	Paneth
TAAACCGTCGGCCGAT-1	Paneth
TAAGAGAAGAGACTTA-1	Paneth
TAAGAGACATGTAAGA-1	Paneth
TAAGCGTCAACGATCT-1	Paneth
TAAGCGTGTATTAGCC-1	Paneth
TAAGCGTTCGTATCAG-1	Paneth
TACACGAAGCGTAATA-1	Paneth
TACACGAGTGCACGAA-1	Paneth
TACACGATCAATACCG-1	Paneth
TACAGTGCAGCATACT-1	Paneth
TACAGTGGTGAGGGAG-1	Paneth
TACAGTGTCGAACGGA-1	Paneth
TACAGTGTCTGCAGTA-1	Paneth
TACAGTGTCTGCGGCA-1	Paneth
TACCTATCAAAGCGGT-1	Paneth
TACCTATCAAAGTCAA-1	Paneth
TACCTATCAGTGACAG-1	Paneth
TACCTATCATCCCACT-1	Paneth
TACCTATTCGTAGATC-1	Paneth
TACCTTAAGTGGTAGC-1	Paneth
TACCTTATCAGTCAGT-1	Paneth
TACCTTATCCTAAGTG-1	Paneth
TACCTTATCCTCATTA-1	Paneth
TACGGATAGGATTCGG-1	Paneth
TACGGGCAGCTTTGGT-1	Paneth
TACGGGCCAAAGCAAT-1	Paneth
TACGGGCGTCTCCACT-1	Paneth
TACGGTACAAGGGTCA-1	Paneth
TACGGTACAGTCGATT-1	Paneth
TACGGTAGTAGAGCTG-1	Paneth
TACGGTATCTACTTAC-1	Paneth
TACTCATAGCTTCGCG-1	Paneth
TACTCATAGGCAGTCA-1	Paneth
TACTCATCACGTCAGC-1	Paneth
TACTCATCATTAGCCA-1	Paneth
TACTCATGTCACCCAG-1	Paneth
TACTCGCAGACAAGCC-1	Paneth
TACTCGCAGTCAAGGC-1	Paneth
TACTCGCCAGCTCGCA-1	Paneth
TACTCGCCAGTCACTA-1	Paneth
TACTCGCCATCACAAC-1	Paneth
TACTCGCGTACAGTTC-1	Paneth
TACTCGCTCAACGAAA-1	Paneth
TACTTACCAAGGACAC-1	Paneth
TACTTACCACCAGGCT-1	Paneth
TACTTACCACGTTGGC-1	Paneth
TACTTACCAGGTTTCA-1	Paneth
TACTTACCATGGAATA-1	Paneth
TACTTACTCTATCCTA-1	Paneth
TACTTGTAGTGGTAAT-1	Paneth
TACTTGTCAACACCCG-1	Paneth
TACTTGTCAGACAGGT-1	Paneth
TACTTGTCAGACTCGC-1	Paneth
TACTTGTCATTCCTGC-1	Paneth
TACTTGTGTGTGTGCC-1	Paneth
TACTTGTTCAAGGCTT-1	Paneth
TACTTGTTCAGAGCTT-1	Paneth
TAGACCAAGCACACAG-1	Paneth
TAGACCACACTGTTAG-1	Paneth
TAGACCAGTGACAAAT-1	Paneth
TAGACCAGTGCATCTA-1	Paneth
TAGACCAGTGTTAAGA-1	Paneth
TAGACCAGTTCAGACT-1	Paneth
TAGAGCTTCACGACTA-1	Paneth
TAGAGCTTCCGTAGTA-1	Paneth
TAGCCGGCACTAAGTC-1	Paneth
TAGCCGGGTACAAGTA-1	Paneth
TAGGCATGTGTGGTTT-1	Paneth
TAGTGGTCAATAAGCA-1	Paneth
TAGTGGTCAGCTTCGG-1	Paneth
TAGTGGTGTATAATGG-1	Paneth
TAGTGGTTCCGCTGTT-1	Paneth
TAGTTGGCAGCTGTTA-1	Paneth
TAGTTGGCATCCAACA-1	Paneth
TAGTTGGGTGGGTATG-1	Paneth
TATCAGGAGGCGCTCT-1	Paneth
TATCAGGCATTGAGCT-1	Paneth
TATCTCAAGAAACGAG-1	Paneth
TATCTCAAGAACAACT-1	Paneth
TATCTCAGTACGAAAT-1	Paneth
TATCTCATCTACTATC-1	Paneth
TATGCCCAGCAATATG-1	Paneth
TATGCCCAGTCGCCGT-1	Paneth
TATGCCCCAGACAAGC-1	Paneth
TATGCCCGTATCTGCA-1	Paneth
TATGCCCTCGATCCCT-1	Paneth
TATTACCAGAGATGAG-1	Paneth
TATTACCAGAGTTGGC-1	Paneth
TATTACCAGATCCCGC-1	Paneth
TATTACCAGCTGATAA-1	Paneth
TATTACCCAGACGTAG-1	Paneth
TATTACCTCCGCGTTT-1	Paneth
TCAACGAAGATCCCGC-1	Paneth
TCAACGAAGTAGGCCA-1	Paneth
TCAACGATCGCGATCG-1	Paneth
TCAATCTAGGCCCTTG-1	Paneth
TCAATCTGTCCTCCAT-1	Paneth
TCAATCTGTCGCGGTT-1	Paneth
TCAATCTTCCTTTACA-1	Paneth
TCAATCTTCGAATGGG-1	Paneth
TCAATCTTCTTGACGA-1	Paneth
TCACAAGCAAACCCAT-1	Paneth
TCACAAGCACAACGCC-1	Paneth
TCACAAGGTTGACGTT-1	Paneth
TCACAAGTCCACGCAG-1	Paneth
TCACAAGTCCAGTAGT-1	Paneth
TCACAAGTCGATCCCT-1	Paneth
TCACGAAAGTAGATGT-1	Paneth
TCACGAACAGTACACT-1	Paneth
TCACGAATCTGCTGCT-1	Paneth
TCAGATGAGATCTGCT-1	Paneth
TCAGATGGTCGAAAGC-1	Paneth
TCAGATGGTTGGTGGA-1	Paneth
TCAGATGTCGGAGGTA-1	Paneth
TCAGCAAAGGACACCA-1	Paneth
TCAGCAAGTATGAATG-1	Paneth
TCAGCAATCGATGAGG-1	Paneth
TCAGCTCCATGATCCA-1	Paneth
TCAGCTCGTCTCCCTA-1	Paneth
TCAGGATAGAAGGCCT-1	Paneth
TCAGGATAGAGCCCAA-1	Paneth
TCAGGATAGCATCATC-1	Paneth
TCAGGATAGGAGTTGC-1	Paneth
TCAGGATGTAGCCTCG-1	Paneth
TCAGGATGTCGGATCC-1	Paneth
TCAGGATGTCTCTTTA-1	Paneth
TCAGGATTCACTGGGC-1	Paneth
TCAGGTAAGCGTGTCC-1	Paneth
TCAGGTAAGTGTCTCA-1	Paneth
TCAGGTACAAGTAGTA-1	Paneth
TCAGGTACATGTAGTC-1	Paneth
TCAGGTAGTTGGTAAA-1	Paneth
TCAGGTAGTTTGCATG-1	Paneth
TCAGGTATCGTACGGC-1	Paneth
TCATTACAGCTAGTTC-1	Paneth
TCATTACAGGATTCGG-1	Paneth
TCATTACAGTGAAGTT-1	Paneth
TCATTACCACTTGGAT-1	Paneth
TCATTTGCAGTGGAGT-1	Paneth
TCATTTGGTCATCGGC-1	Paneth
TCCACACAGAGTCGGT-1	Paneth
TCCACACCAGTAACGG-1	Paneth
TCCCGATAGATAGCAT-1	Paneth
TCCCGATCATGTTGAC-1	Paneth
TCCCGATTCCTCGCAT-1	Paneth
TCCCGATTCCTGTAGA-1	Paneth
TCGAGGCAGACAAAGG-1	Paneth
TCGAGGCAGGCTAGAC-1	Paneth
TCGAGGCAGTCACGCC-1	Paneth
TCGAGGCCAGTGACAG-1	Paneth
TCGAGGCGTCGAGTTT-1	Paneth
TCGAGGCTCACAGTAC-1	Paneth
TCGAGGCTCATCATTC-1	Paneth
TCGAGGCTCGCTTGTC-1	Paneth
TCGCGAGAGAGCCTAG-1	Paneth
TCGCGAGAGGTGCACA-1	Paneth
TCGCGAGAGTCCATAC-1	Paneth
TCGCGAGGTACTCAAC-1	Paneth
TCGCGAGGTGTCTGAT-1	Paneth
TCGCGAGTCCTGTAGA-1	Paneth
TCGCGTTAGACGCTTT-1	Paneth
TCGCGTTAGGCCGAAT-1	Paneth
TCGGGACGTCCAACTA-1	Paneth
TCGGGACTCCGCAAGC-1	Paneth
TCGGGACTCTTCGGTC-1	Paneth
TCGGTAACACCGAATT-1	Paneth
TCGGTAACAGTCGTGC-1	Paneth
TCGGTAACATAACCTG-1	Paneth
TCGGTAAGTGTTGGGA-1	Paneth
TCGGTAATCTGCGACG-1	Paneth
TCGTACCAGACACGAC-1	Paneth
TCGTACCAGGACTGGT-1	Paneth
TCGTACCAGGCTCAGA-1	Paneth
TCGTACCCACATTTCT-1	Paneth
TCGTACCGTCTGCCAG-1	Paneth
TCGTACCTCAGTCAGT-1	Paneth
TCGTAGACAATGACCT-1	Paneth
TCGTAGATCCACGCAG-1	Paneth
TCGTAGATCCAGAGGA-1	Paneth
TCGTAGATCGCAAACT-1	Paneth
TCTATTGAGGCTACGA-1	Paneth
TCTATTGAGTACGCCC-1	Paneth
TCTATTGCACGAGGTA-1	Paneth
TCTATTGTCTTGAGAC-1	Paneth
TCTCATACAGACACTT-1	Paneth
TCTCATAGTAATAGCA-1	Paneth
TCTCTAAAGACTTTCG-1	Paneth
TCTCTAAAGCTACCTA-1	Paneth
TCTCTAACAACTGGCC-1	Paneth
TCTCTAACAGGTCCAC-1	Paneth
TCTGAGAAGATCACGG-1	Paneth
TCTGAGACAAACCCAT-1	Paneth
TCTGAGACACTCGACG-1	Paneth
TCTGAGAGTACAGACG-1	Paneth
TCTGGAACACAAGCCC-1	Paneth
TCTGGAACACGAAACG-1	Paneth
TCTGGAATCCAATGGT-1	Paneth
TCTTCGGAGACAGAGA-1	Paneth
TCTTCGGAGGGAGTAA-1	Paneth
TCTTCGGAGTGGGCTA-1	Paneth
TCTTCGGCATGAACCT-1	Paneth
TCTTCGGTCTTGACGA-1	Paneth
TCTTTCCAGAGTGACC-1	Paneth
TCTTTCCAGCGTCAAG-1	Paneth
TGAAAGACACAGAGGT-1	Paneth
TGAAAGAGTGACGCCT-1	Paneth
TGACAACGTAGAAGGA-1	Paneth
TGACAACGTCCGTGAC-1	Paneth
TGACAACGTTACGTCA-1	Paneth
TGACAACTCACATAGC-1	Paneth
TGACAACTCCATTCTA-1	Paneth
TGACAACTCGTTGCCT-1	Paneth
TGACAACTCTGGTATG-1	Paneth
TGACGGCCACTACAGT-1	Paneth
TGACGGCCAGCCAATT-1	Paneth
TGACGGCGTTACGGAG-1	Paneth
TGACTAGAGTATCGAA-1	Paneth
TGACTAGCAAGACACG-1	Paneth
TGACTAGGTGCAACGA-1	Paneth
TGACTAGTCGTAGATC-1	Paneth
TGACTTTGTCGCATCG-1	Paneth
TGACTTTGTGTGACCC-1	Paneth
TGAGAGGAGTACATGA-1	Paneth
TGAGAGGCAAGACGTG-1	Paneth
TGAGAGGGTAGCGCAA-1	Paneth
TGAGAGGTCAGAGACG-1	Paneth
TGAGCATAGTGAATTG-1	Paneth
TGAGCATCACGCCAGT-1	Paneth
TGAGCATGTCACTTCC-1	Paneth
TGAGCATGTGAAGGCT-1	Paneth
TGAGCATTCACGAAGG-1	Paneth
TGAGCCGCAGCGATCC-1	Paneth
TGAGGGAAGTGGCACA-1	Paneth
TGAGGGAAGTTGTCGT-1	Paneth
TGAGGGAGTGGACGAT-1	Paneth
TGAGGGAGTGTAATGA-1	Paneth
TGATTTCAGCGACGTA-1	Paneth
TGATTTCGTGTGCGTC-1	Paneth
TGATTTCTCACTATTC-1	Paneth
TGCACCTGTCTACCTC-1	Paneth
TGCACCTGTTATGTGC-1	Paneth
TGCACCTGTTCCAACA-1	Paneth
TGCCAAAAGCGCCTCA-1	Paneth
TGCCAAAAGCTGAAAT-1	Paneth
TGCCAAACACGAAATA-1	Paneth
TGCCAAACACGTTGGC-1	Paneth
TGCCAAATCACAGTAC-1	Paneth
TGCCCATAGCCAGGAT-1	Paneth
TGCCCATGTGGTCTCG-1	Paneth
TGCCCATTCCGAAGAG-1	Paneth
TGCCCTAAGACTCGGA-1	Paneth
TGCCCTAAGCAAATCA-1	Paneth
TGCCCTAGTACTCGCG-1	Paneth
TGCCCTATCCCGGATG-1	Paneth
TGCGCAGCACTTCGAA-1	Paneth
TGCGCAGGTAATCACC-1	Paneth
TGCGCAGGTCAGGACA-1	Paneth
TGCGCAGGTCAGTGGA-1	Paneth
TGCGCAGGTCTTCGTC-1	Paneth
TGCGCAGGTGTATGGG-1	Paneth
TGCGGGTAGTGCTGCC-1	Paneth
TGCGGGTTCGGACAAG-1	Paneth
TGCGTGGCACATTAGC-1	Paneth
TGCGTGGCAGGATTGG-1	Paneth
TGCGTGGCATTACCTT-1	Paneth
TGCGTGGGTTGGTTTG-1	Paneth
TGCGTGGGTTGTACAC-1	Paneth
TGCGTGGTCAGCTCGG-1	Paneth
TGCGTGGTCAGCTCTC-1	Paneth
TGCGTGGTCGTTTATC-1	Paneth
TGCTACCAGACTGTAA-1	Paneth
TGCTACCAGTGTACCT-1	Paneth
TGCTACCCACTCTGTC-1	Paneth
TGCTACCGTCTTCGTC-1	Paneth
TGCTGCTCACTAAGTC-1	Paneth
TGCTGCTCAGGGAGAG-1	Paneth
TGCTGCTGTCAGGACA-1	Paneth
TGCTGCTTCCTCAACC-1	Paneth
TGGACGCAGACTCGGA-1	Paneth
TGGACGCCACAGACAG-1	Paneth
TGGACGCCACTTCTGC-1	Paneth
TGGACGCTCGGAAATA-1	Paneth
TGGACGCTCTGTACGA-1	Paneth
TGGCCAGAGATGCCTT-1	Paneth
TGGCCAGAGTTATCGC-1	Paneth
TGGCCAGCACGCGAAA-1	Paneth
TGGCCAGGTCCGAGTC-1	Paneth
TGGCCAGTCAGTTGAC-1	Paneth
TGGCGCACAGATCCAT-1	Paneth
TGGCGCAGTCGCATAT-1	Paneth
TGGCGCAGTGATGTCT-1	Paneth
TGGCGCATCATCGGAT-1	Paneth
TGGCTGGAGTCTCGGC-1	Paneth
TGGGAAGAGCACGCCT-1	Paneth
TGGGAAGCACAGGTTT-1	Paneth
TGGGAAGCAGGACCCT-1	Paneth
TGGGAAGGTAGGCTGA-1	Paneth
TGGGAAGGTTCAGCGC-1	Paneth
TGGGAAGTCAGTTGAC-1	Paneth
TGGGAAGTCTTGTTTG-1	Paneth
TGGGCGTAGCCGGTAA-1	Paneth
TGGGCGTGTCAAAGAT-1	Paneth
TGGGCGTGTCCAAGTT-1	Paneth
TGGGCGTTCCAGTATG-1	Paneth
TGGGCGTTCTGTCCGT-1	Paneth
TGGTTAGCAAGACACG-1	Paneth
TGGTTAGCATAGTAAG-1	Paneth
TGGTTAGCATCTCCCA-1	Paneth
TGGTTAGGTCGATTGT-1	Paneth
TGGTTAGTCAGTGTTG-1	Paneth
TGGTTAGTCGGAAACG-1	Paneth
TGGTTAGTCTTTAGGG-1	Paneth
TGGTTCCAGAGTCTGG-1	Paneth
TGGTTCCAGCGATAGC-1	Paneth
TGGTTCCAGGTGCTTT-1	Paneth
TGGTTCCAGTTAGGTA-1	Paneth
TGGTTCCTCAGTTCGA-1	Paneth
TGGTTCCTCGAACGGA-1	Paneth
TGTATTCAGAGCTGGT-1	Paneth
TGTATTCGTACCATCA-1	Paneth
TGTATTCGTTTCCACC-1	Paneth
TGTATTCGTTTGTTTC-1	Paneth
TGTCCCAAGCCTCGTG-1	Paneth
TGTCCCAAGTACACCT-1	Paneth
TGTCCCACACAAGCCC-1	Paneth
TGTCCCAGTAACGTTC-1	Paneth
TGTCCCATCACTTATC-1	Paneth
TGTCCCATCGCAGGCT-1	Paneth
TGTCCCATCGTACGGC-1	Paneth
TGTCCCATCTTACCGC-1	Paneth
TGTGGTACAAGACGTG-1	Paneth
TGTGGTACAATGAAAC-1	Paneth
TGTGGTAGTAGGGACT-1	Paneth
TGTGGTAGTCGCGTGT-1	Paneth
TGTGGTAGTTCTCATT-1	Paneth
TGTGTTTCACATAACC-1	Paneth
TGTGTTTGTTCCACGG-1	Paneth
TGTTCCGAGTGTCCAT-1	Paneth
TGTTCCGCATCCGGGT-1	Paneth
TGTTCCGGTAACGACG-1	Paneth
TGTTCCGGTCTACCTC-1	Paneth
TGTTCCGTCGCAAACT-1	Paneth
TTAACTCCAGTAAGCG-1	Paneth
TTAACTCCATACTCTT-1	Paneth
TTAACTCGTACAGTTC-1	Paneth
TTAACTCTCGGAGCAA-1	Paneth
TTAGGACAGAGACTTA-1	Paneth
TTAGGACAGCTAGGCA-1	Paneth
TTAGGACCACAACGCC-1	Paneth
TTAGGACCACGAGGTA-1	Paneth
TTAGGACCATGAACCT-1	Paneth
TTAGGACGTTGTGGAG-1	Paneth
TTAGGACTCAGGTTCA-1	Paneth
TTAGTTCCATTGGCGC-1	Paneth
TTAGTTCGTGGTACAG-1	Paneth
TTAGTTCTCCAGAGGA-1	Paneth
TTAGTTCTCGTTTGCC-1	Paneth
TTAGTTCTCTAAGCCA-1	Paneth
TTCCCAGCAATGGTCT-1	Paneth
TTCCCAGCATTTGCCC-1	Paneth
TTCGAAGAGGTAGCCA-1	Paneth
TTCGAAGCATGCATGT-1	Paneth
TTCGAAGGTAGCACGA-1	Paneth
TTCGAAGGTGCGATAG-1	Paneth
TTCGAAGTCCACGACG-1	Paneth
TTCGGTCCAGATAATG-1	Paneth
TTCGGTCGTAAGGGAA-1	Paneth
TTCGGTCGTTCAGACT-1	Paneth
TTCGGTCTCCTTTACA-1	Paneth
TTCTACACAAACGTGG-1	Paneth
TTCTACAGTTCACGGC-1	Paneth
TTCTACAGTTCCGGCA-1	Paneth
TTCTACATCGAATGCT-1	Paneth
TTCTCAACATGCAATC-1	Paneth
TTCTCAATCGAGAGCA-1	Paneth
TTCTCCTAGTGTACCT-1	Paneth
TTCTCCTAGTTTAGGA-1	Paneth
TTCTCCTCACTTAACG-1	Paneth
TTCTCCTGTTAGATGA-1	Paneth
TTCTCCTTCTAGAGTC-1	Paneth
TTCTTAGAGGCTCATT-1	Paneth
TTCTTAGCACGGCGTT-1	Paneth
TTCTTAGGTTACGACT-1	Paneth
TTCTTAGTCATGTCCC-1	Paneth
TTGAACGAGATGCCTT-1	Paneth
TTGAACGAGGGTGTGT-1	Paneth
TTGAACGAGTCACGCC-1	Paneth
TTGAACGCAAAGTCAA-1	Paneth
TTGAACGGTCTCCATC-1	Paneth
TTGACTTAGCCGATTT-1	Paneth
TTGACTTAGGTAAACT-1	Paneth
TTGCCGTAGATGTGTA-1	Paneth
TTGCCGTAGCTTCGCG-1	Paneth
TTGCCGTCAAGCCCAC-1	Paneth
TTGCCGTGTCGGGTCT-1	Paneth
TTGCGTCAGACCTTTG-1	Paneth
TTGCGTCTCCAGTAGT-1	Paneth
TTGGAACAGATAGGAG-1	Paneth
TTGGAACAGCTTATCG-1	Paneth
TTGGAACCACAGCCCA-1	Paneth
TTGGAACCAGGTCTCG-1	Paneth
TTGGAACCATTAGGCT-1	Paneth
TTGGAACGTCTGCGGT-1	Paneth
TTGGAACTCCCAAGAT-1	Paneth
TTGGCAAGTCCCTTGT-1	Paneth
TTGGCAAGTCGCGAAA-1	Paneth
TTGGCAATCCTACAGA-1	Paneth
TTGGCAATCTCGGACG-1	Paneth
TTGGCAATCTGCGTAA-1	Paneth
TTGTAGGAGAGCCTAG-1	Paneth
TTGTAGGAGGAACTGC-1	Paneth
TTGTAGGCACCTGGTG-1	Paneth
TTTACTGAGCGTAGTG-1	Paneth
TTTATGCAGGGTATCG-1	Paneth
TTTCCTCCAGACTCGC-1	Paneth
TTTCCTCGTATATGAG-1	Paneth
TTTCCTCTCATCATTC-1	Paneth
TTTGCGCAGAGGGCTT-1	Paneth
TTTGCGCCACTTCTGC-1	Paneth
TTTGCGCGTTACGCGC-1	Paneth
TTTGCGCTCATTGCGA-1	Paneth
TTTGCGCTCTCTGTCG-1	Paneth
TTTGGTTAGCGATGAC-1	Paneth
TTTGGTTCATGCCTTC-1	Paneth
TTTGGTTGTGGTCCGT-1	Paneth
TTTGGTTGTTCTGGTA-1	Paneth
TTTGTCAAGACTTTCG-1	Paneth
TTTGTCAAGCAGCGTA-1	Paneth
TTTGTCAGTGCCTGGT-1	Paneth
TTTGTCAGTGGGTATG-1	Paneth
TTTGTCATCGTTGACA-1	Paneth
AAACCTGAGGTTCCTA-1	TA
AAAGCAAGTGATGTGG-1	TA
AAATGCCAGCATCATC-1	TA
AACCATGTCTGTCAAG-1	TA
AACTCAGGTTCAGCGC-1	TA
AAGCCGCAGGCATGTG-1	TA
AAGCCGCCAGCCTTTC-1	TA
AAGGCAGAGCGAGAAA-1	TA
AAGGCAGTCCGTCAAA-1	TA
AATCGGTTCCACTCCA-1	TA
ACACCCTCATGCATGT-1	TA
ACACCGGTCCTGTAGA-1	TA
ACAGCTAAGAAGGTTT-1	TA
ACGATGTTCACCTCGT-1	TA
ACGCCAGGTCCATGAT-1	TA
ACTGATGCACGGTTTA-1	TA
ACTTTCACAAAGGTGC-1	TA
AGAGCTTAGAAGGGTA-1	TA
AGAGTGGAGCGTCTAT-1	TA
AGATCTGCAGAAGCAC-1	TA
AGCAGCCTCCCATTTA-1	TA
AGCATACTCGATCCCT-1	TA
AGCGGTCAGGCCCTTG-1	TA
AGCGTATAGACAATAC-1	TA
AGCTCCTCACCGAATT-1	TA
AGCTCCTGTAAACACA-1	TA
AGGCCACAGCAGACTG-1	TA
AGGCCACAGGCAGTCA-1	TA
AGGCCACTCATGGTCA-1	TA
AGGGATGCAAATCCGT-1	TA
AGTAGTCAGGCAGGTT-1	TA
AGTGAGGTCAAACCAC-1	TA
AGTGGGATCTCTGCTG-1	TA
AGTTGGTCAGCCTTGG-1	TA
ATAACGCCATTGGGCC-1	TA
ATCACGAAGCGATAGC-1	TA
ATCTACTCATAGTAAG-1	TA
ATGAGGGAGACGACGT-1	TA
ATGCGATGTACCGAGA-1	TA
ATGGGAGTCCTCTAGC-1	TA
ATTACTCAGTACGCGA-1	TA
ATTATCCCAGCTGCAC-1	TA
ATTATCCTCGTAGGAG-1	TA
ATTCTACAGTACGACG-1	TA
ATTCTACGTTAGATGA-1	TA
ATTGGACAGGTGGGTT-1	TA
CAACCAAGTAAGAGGA-1	TA
CAAGATCGTACTTAGC-1	TA
CAAGTTGCAGTGGGAT-1	TA
CAAGTTGCATAGGATA-1	TA
CACACAACACTGAAGG-1	TA
CACACTCGTGGCGAAT-1	TA
CACCAGGGTATCTGCA-1	TA
CAGAATCCAAGAAGAG-1	TA
CAGATCAAGAGCCCAA-1	TA
CAGCAGCTCATGCTCC-1	Paneth
CAGCTAAGTGTTTGGT-1	TA
CAGCTGGAGTGGGATC-1	TA
CATATGGTCACCGTAA-1	TA
CATCGAACACCGAATT-1	TA
CATGCCTGTCCTCTTG-1	TA
CATGGCGAGTCCAGGA-1	TA
CCACTACGTTTGTTTC-1	TA
CCATTCGGTAACGTTC-1	TA
CCCATACGTCGGCTCA-1	TA
CCCTCCTCAAGCTGTT-1	TA
CCGGTAGCATTACCTT-1	TA
CCGGTAGGTATCACCA-1	TA
CCGTTCAGTTCTGGTA-1	TA
CCTAAAGCAGGCTGAA-1	TA
CCTATTAAGCGCCTTG-1	TA
CCTATTAGTACAGACG-1	TA
CCTCTGAGTGGTTTCA-1	TA
CGAACATCAATCAGAA-1	TA
CGAACATGTGCAGACA-1	TA
CGACCTTTCCTCAACC-1	TA
CGACTTCTCAACACTG-1	TA
CGACTTCTCTGTCTAT-1	TA
CGAGCACCAGAGTGTG-1	TA
CGAGCACGTCAGAGGT-1	TA
CGATGTACATATACCG-1	TA
CGATGTATCGGCGGTT-1	TA
CGATTGACAACTGCGC-1	TA
CGCGGTACAAACCTAC-1	TA
CGCGTTTAGGCAGGTT-1	TA
CGCTATCCATACTACG-1	TA
CGGACGTTCCTCAATT-1	TA
CGGACTGAGAGTCTGG-1	TA
CGGACTGGTGTTTGGT-1	TA
CGGACTGTCCTCAACC-1	TA
CGGAGTCGTTGACGTT-1	TA
CGGAGTCTCCGCATAA-1	TA
CGGAGTCTCGTCTGCT-1	TA
CGGGTCAGTTATCACG-1	TA
CGGTTAAAGATCACGG-1	TA
CGTAGGCGTAGCTGCC-1	TA
CGTCACTCAAGTACCT-1	TA
CGTCTACAGTACGCGA-1	TA
CGTGAGCTCAACACCA-1	TA
CGTTAGATCAATACCG-1	TA
CTACATTAGGGTGTTG-1	TA
CTACATTTCTGTTTGT-1	TA
CTACGTCGTAGCGTAG-1	TA
CTCATTAAGGGAAACA-1	TA
CTCATTAAGTAATCCC-1	TA
CTCGAAACATCTGGTA-1	TA
CTCGTACAGGTGCTTT-1	TA
CTCGTCAGTACAGCAG-1	TA
CTGAAGTAGACACTAA-1	TA
CTGATAGAGATGTCGG-1	TA
CTGATCCCAGGTCGTC-1	TA
CTGGTCTGTACAAGTA-1	TA
CTTACCGCAAATTGCC-1	TA
CTTCTCTGTCGTTGTA-1	TA
GAACCTAAGACTACAA-1	TA
GAACCTAGTAGGGACT-1	TA
GAACGGAAGGGATACC-1	TA
GAACGGACAAAGTCAA-1	TA
GAAGCAGTCAATACCG-1	TA
GAAGCAGTCCGCAGTG-1	TA
GAATAAGGTGACAAAT-1	Paneth
GACAGAGAGGACCACA-1	TA
GACCAATCACGGCCAT-1	TA
GACGCGTCATTGAGCT-1	TA
GACGGCTTCCAAACTG-1	TA
GACGTGCCATTTGCCC-1	TA
GATCTAGTCAAGGCTT-1	TA
GATGCTACATTAGCCA-1	TA
GCAAACTAGCCAGGAT-1	TA
GCAATCATCCGGCACA-1	TA
GCACATAGTAGCTAAA-1	TA
GCACATATCTAACCGA-1	TA
GCAGCCAAGTGTTGAA-1	TA
GCAGTTAGTATAGGGC-1	TA
GCAGTTAGTTCGGGCT-1	TA
GCATACATCCCGGATG-1	TA
GCCTCTACATCCTAGA-1	TA
GCGAGAACAATGAATG-1	TA
GCGCAGTAGTCCCACG-1	TA
GCGCAGTGTCAGAATA-1	TA
GCGCCAAGTGCGATAG-1	TA
GCTCTGTAGGCACATG-1	TA
GCTGCGACACGTAAGG-1	TA
GCTGCGACATATACCG-1	TA
GCTTGAATCGATGAGG-1	TA
GGAACTTCACCGCTAG-1	TA
GGAATAACACGGTGTC-1	TA
GGACATTTCGCTGATA-1	TA
GGCTCGACACACTGCG-1	TA
GGCTCGACATCGGGTC-1	TA
GGGACCTTCACAGTAC-1	TA
GGGACCTTCTCCAGGG-1	TA
GGGATGAAGACGCACA-1	TA
GGGATGAGTGGTAACG-1	Paneth
GGGCACTTCAACCAAC-1	TA
GGGTCTGTCCCTAATT-1	TA
GGGTTGCCATGGATGG-1	TA
GGTGTTAGTCTGCGGT-1	TA
GTAACGTGTCGATTGT-1	TA
GTACTTTTCAGCACAT-1	TA
GTAGGCCAGGAGTCTG-1	TA
GTAGTCATCAGCTCTC-1	TA
GTCCTCATCGGATGTT-1	TA
GTCTCGTGTCACAAGG-1	TA
GTGCATAGTTTGCATG-1	TA
GTGCATATCATAAAGG-1	TA
GTGGGTCTCCGGGTGT-1	TA
GTGTGCGTCATTATCC-1	TA
GTGTTAGGTAAACACA-1	TA
GTTAAGCTCCTTTCTC-1	TA
GTTCATTCAACTGCGC-1	TA
GTTCGGGAGACAGGCT-1	TA
GTTTCTACATGCCCGA-1	TA
TAAACCGAGAAGGGTA-1	TA
TACAGTGAGTGGACGT-1	TA
TACCTATAGTGTACCT-1	TA
TACCTATGTCCGTGAC-1	TA
TACGGATGTCCTCCAT-1	TA
TACGGGCCACATGACT-1	TA
TACGGTATCTACCAGA-1	TA
TACTCATGTCAATGTC-1	TA
TAGACCAAGCTGTTCA-1	TA
TAGACCAGTAAGAGGA-1	TA
TAGACCAGTAGCAAAT-1	TA
TAGACCATCACGGTTA-1	TA
TAGAGCTAGAATGTGT-1	TA
TAGAGCTCAGTTCCCT-1	TA
TAGAGCTCATTTGCCC-1	TA
TAGGCATGTGTCAATC-1	TA
TATCAGGAGACGCAAC-1	TA
TATTACCGTCCAAGTT-1	TA
TCACAAGAGCTTTGGT-1	TA
TCAGATGTCTGACCTC-1	Paneth
TCAGCTCTCCGATATG-1	TA
TCATTACCACGAGAGT-1	Paneth
TCCACACTCCCTTGCA-1	TA
TCGCGTTCAGACAAGC-1	TA
TCGTAGAGTGAACCTT-1	TA
TCTATTGGTGCAGACA-1	TA
TCTCATAAGGTGTTAA-1	TA
TCTCATATCAACACGT-1	TA
TCTCTAATCCGAACGC-1	TA
TCTGGAATCCTATTCA-1	TA
TGAAAGACAGGAATGC-1	TA
TGACTAGCAGCCACCA-1	TA
TGACTAGGTCTTGTCC-1	Paneth
TGAGAGGAGCATGGCA-1	TA
TGATTTCGTAGCTCCG-1	TA
TGCCAAAAGATCCCGC-1	TA
TGCCCTACACTCGACG-1	TA
TGCTACCAGCACAGGT-1	TA
TGGCGCAGTAGCGATG-1	TA
TGTCCCACACCCATTC-1	TA
TTCCCAGGTGCGCTTG-1	TA
TTCTACACAAATTGCC-1	TA
TTCTTAGTCTCGTTTA-1	TA
TTGACTTTCACCGGGT-1	TA
TTGCCGTAGCACGCCT-1	TA
TTGCCGTGTTATTCTC-1	TA
TTGCGTCTCTGGCGTG-1	TA
TTTATGCAGCAGCCTC-1	TA
TTTATGCAGCGCCTTG-1	TA
TTTCCTCGTTCCCGAG-1	TA
TTTGCGCAGAGCTTCT-1	TA
TTTGGTTCAGCTGTAT-1	TA
AAACCTGGTTTACTCT-1	unclassified
AAAGCAATCTGTCCGT-1	unclassified
AACTGGTGTAGAGGAA-1	unclassified
AACTTTCAGTGTTGAA-1	unclassified
AATCGGTCACAAGTAA-1	unclassified
AATCGGTGTGCACTTA-1	unclassified
ACACCAACACCAACCG-1	unclassified
ACCTTTAGTTATTCTC-1	unclassified
ACGATGTCAAAGAATC-1	unclassified
ACGATGTGTTCCCGAG-1	unclassified
ACGCAGCTCAAAGACA-1	unclassified
ACTGAACCAATAGAGT-1	unclassified
ACTTACTAGCTAAACA-1	unclassified
AGAATAGAGGCTAGGT-1	unclassified
AGAGCTTCAGTTAACC-1	unclassified
AGCGTATCAAGAGTCG-1	unclassified
AGCTCTCCACCGCTAG-1	unclassified
AGGGATGCACGGCTAC-1	unclassified
AGGTCCGGTATATCCG-1	unclassified
AGTCTTTCATGCCTTC-1	unclassified
AGTGAGGAGTGGTAGC-1	unclassified
AGTGTCATCCGAACGC-1	unclassified
ATAACGCAGTGAAGTT-1	unclassified
ATAACGCGTCTTTCAT-1	unclassified
ATAACGCTCGTAGATC-1	unclassified
ATAGACCCAGATGGGT-1	unclassified
ATCTGCCAGAATGTGT-1	unclassified
ATCTGCCGTACCAGTT-1	unclassified
ATCTGCCTCTAGAGTC-1	unclassified
ATGAGGGCAAGCCTAT-1	unclassified
ATGGGAGTCGCATGAT-1	unclassified
ATTGGACTCGTGGTCG-1	unclassified
CACAGGCAGGGTCTCC-1	unclassified
CACAGGCGTTTGGCGC-1	unclassified
CACAGTAAGACATAAC-1	unclassified
CACAGTAGTAGCCTAT-1	unclassified
CACAGTAGTATCACCA-1	unclassified
CACATTTCACGAGAGT-1	unclassified
CAGAATCGTATTAGCC-1	unclassified
CAGCGACTCTCCGGTT-1	unclassified
CAGCTGGAGCAGGTCA-1	unclassified
CAGGTGCTCGGAAACG-1	unclassified
CAGTAACCATCGTCGG-1	unclassified
CATATTCCATGGTTGT-1	unclassified
CATATTCGTGGTACAG-1	unclassified
CATCAAGAGTGCAAGC-1	unclassified
CATCCACTCTATCGCC-1	unclassified
CATTATCCAAATCCGT-1	unclassified
CATTATCGTCGCGTGT-1	unclassified
CATTCGCGTAAATGAC-1	unclassified
CATTCGCGTTCGTTGA-1	unclassified
CCACCTATCTGTCTAT-1	unclassified
CCACGGACATGCTAGT-1	unclassified
CCACGGATCTAACCGA-1	unclassified
CCACTACCAGCTGCAC-1	unclassified
CCATGTCAGGTGCAAC-1	unclassified
CCGGTAGCAATGGTCT-1	unclassified
CCGGTAGTCCAAGTAC-1	unclassified
CCGTTCATCAGAGGTG-1	unclassified
CCTACCAAGCTTCGCG-1	unclassified
CCTCTGAGTTCCATGA-1	unclassified
CCTCTGATCACAACGT-1	unclassified
CCTTCCCCACGGATAG-1	unclassified
CCTTCGACACAGACTT-1	unclassified
CGATCGGCAATAACGA-1	unclassified
CGATGGCTCATGCTCC-1	unclassified
CGATGTAGTCTGGTCG-1	unclassified
CGCTGGAAGCTGATAA-1	unclassified
CGCTGGATCAGCTTAG-1	unclassified
CGCTTCATCAGTCAGT-1	unclassified
CGGACGTAGCGGCTTC-1	unclassified
CGGACGTCAATCCGAT-1	unclassified
CGGACTGAGATAGGAG-1	unclassified
CGGACTGCAAAGGAAG-1	unclassified
CGGACTGTCACTCTTA-1	unclassified
CGGAGCTAGAGTACCG-1	unclassified
CGGAGCTTCTCGTATT-1	unclassified
CGGAGTCAGTGGGCTA-1	unclassified
CGGTTAATCTAGAGTC-1	unclassified
CGTCAGGAGCCAGAAC-1	unclassified
CGTCTACCAAGGTGTG-1	unclassified
CTAAGACCACATAACC-1	unclassified
CTAAGACGTAGAGTGC-1	unclassified
CTAAGACGTTACAGAA-1	unclassified
CTAATGGAGGACTGGT-1	unclassified
CTACACCAGAATGTTG-1	unclassified
CTACGTCCAGTTCCCT-1	unclassified
CTAGCCTGTGCGAAAC-1	unclassified
CTAGTGACATCAGTAC-1	unclassified
CTCACACAGACCTAGG-1	unclassified
CTCATTACACAGCCCA-1	unclassified
CTCGTACGTCCGTCAG-1	unclassified
CTCGTCACATCCGTGG-1	unclassified
CTCTGGTTCTGGTTCC-1	unclassified
CTGAAACAGACGACGT-1	unclassified
CTGATAGAGTGGACGT-1	unclassified
CTGATAGGTTCACGGC-1	unclassified
GAATAAGTCGTTGACA-1	unclassified
GAATGAAGTGCACGAA-1	unclassified
GAATGAATCAGCGACC-1	unclassified
GACCTGGTCTCCAGGG-1	unclassified
GACGCGTGTGCATCTA-1	unclassified
GATCGCGTCAGGTAAA-1	unclassified
GATGAAACATCGGTTA-1	unclassified
GCAGCCAGTGACTCAT-1	unclassified
GCATGATCAAGAGGCT-1	unclassified
GCATGCGTCAGTTGAC-1	unclassified
GCATGTATCACCTCGT-1	unclassified
GCGACCACACGCTTTC-1	unclassified
GCGCAACTCCGTCAAA-1	unclassified
GCGCCAACACCAGTTA-1	unclassified
GCGGGTTAGTACGTTC-1	unclassified
GCTCCTAAGTGAACAT-1	unclassified
GCTGCAGGTAGCTAAA-1	unclassified
GCTGCGAAGATCTGCT-1	unclassified
GCTTCCAAGGAATGGA-1	unclassified
GGCGACTTCAATCACG-1	unclassified
GGGAATGAGTACGACG-1	unclassified
GGGCACTAGCCAGAAC-1	unclassified
GGGTTGCAGACTAGAT-1	unclassified
GGTGAAGTCGTCTGAA-1	unclassified
GGTGTTAAGCACGCCT-1	unclassified
GTAGGCCTCTGGCGTG-1	unclassified
GTCACAACAGACAGGT-1	unclassified
GTCTTCGAGAAACCGC-1	unclassified
GTGCATAGTTGATTCG-1	unclassified
GTGTGCGGTAGCTCCG-1	unclassified
GTGTTAGAGCGCCTTG-1	unclassified
GTTACAGGTATATCCG-1	unclassified
GTTCATTTCGCCCTTA-1	unclassified
GTTCTCGGTCTCTCGT-1	unclassified
TAAACCGGTCACTTCC-1	unclassified
TAAGTGCTCCGTAGTA-1	unclassified
TACACGAAGGTGCTAG-1	unclassified
TACACGACAACACGCC-1	unclassified
TACCTATAGTTCGATC-1	unclassified
TACGGGCCATGTAGTC-1	unclassified
TACTCATCAGGCTCAC-1	unclassified
TACTTGTGTGTTAAGA-1	unclassified
TAGACCACAAAGCGGT-1	unclassified
TAGAGCTTCTGGTTCC-1	unclassified
TATCTCATCAACACTG-1	unclassified
TATTACCCACGGCGTT-1	unclassified
TCAATCTCACCGGAAA-1	unclassified
TCAGGATGTGAAGGCT-1	unclassified
TCAGGTAAGCATCATC-1	unclassified
TCAGGTAGTTCCCGAG-1	unclassified
TCATTACTCCCATTTA-1	unclassified
TCCACACTCTATCCCG-1	unclassified
TCGTACCGTTGTACAC-1	unclassified
TCTCTAACAGGAATCG-1	unclassified
TCTCTAACATGGTAGG-1	unclassified
TGAGCCGTCTTGTTTG-1	unclassified
TGAGGGAAGTGAATTG-1	unclassified
TGCACCTTCATACGGT-1	unclassified
TGCCCATTCGGCGCAT-1	unclassified
TGCGGGTAGTGAACGC-1	unclassified
TGCGTGGAGACTAGGC-1	unclassified
TGCTGCTCACGGTAGA-1	unclassified
TGGCTGGTCAACGGGA-1	unclassified
TGGGAAGAGTTTAGGA-1	unclassified
TGGGCGTAGATGCCAG-1	unclassified
TGGGCGTTCATGCTCC-1	unclassified
TGGTTAGAGTGACATA-1	unclassified
TGTGTTTAGGATGGAA-1	unclassified
TGTTCCGTCTGAGTGT-1	unclassified
TTATGCTGTACCGTTA-1	unclassified
TTCGAAGCAGTCGTGC-1	unclassified
TTGAACGCAAGAAAGG-1	unclassified
TTGAACGCATAGAAAC-1	unclassified
TTGCCGTCATCACGAT-1	unclassified
TTGCCGTTCCTGCTTG-1	unclassified
TTTATGCGTCAGGACA-1	unclassified
TTTCCTCAGTCCCACG-1	unclassified
TTTGGTTCAGGTCTCG-1	unclassified
TTTGTCAAGATATGGT-1	unclassified
AAACCTGTCTGCGACG-1	unclassified
AAACGGGAGACAGACC-1	unclassified
AAAGCAAGTTCCATGA-1	unclassified
AACACGTGTAAATGAC-1	unclassified
AACCATGTCTCGTATT-1	unclassified
AACCGCGTCACTTACT-1	unclassified
AACCGCGTCCATGAGT-1	unclassified
AACTCAGCAATAGAGT-1	unclassified
AACTCAGTCTCCGGTT-1	unclassified
AACTCCCAGCAGATCG-1	unclassified
AACTCCCGTAAGCACG-1	unclassified
AACTCCCGTAGGGTAC-1	unclassified
AACTCTTAGGTGCTTT-1	unclassified
AACTCTTTCGCATGAT-1	unclassified
AACTCTTTCGCCCTTA-1	unclassified
AACTCTTTCGTAGATC-1	unclassified
AACTGGTTCACTTATC-1	unclassified
AAGGAGCTCTCTAAGG-1	unclassified
AAGGTTCAGACCCACC-1	unclassified
AAGGTTCGTCTACCTC-1	unclassified
AATCCAGTCACGAAGG-1	unclassified
AATCGGTTCTACGAGT-1	unclassified
ACACCGGCATTGGCGC-1	unclassified
ACACTGAAGAAGGCCT-1	unclassified
ACACTGAGTTAGTGGG-1	unclassified
ACACTGATCGGACAAG-1	unclassified
ACAGCCGTCTTATCTG-1	unclassified
ACAGCTAGTGCCTTGG-1	unclassified
ACAGCTATCAACGAAA-1	unclassified
ACATGGTCATGTCCTC-1	unclassified
ACCAGTAAGAAGAAGC-1	unclassified
ACCAGTATCCGCATAA-1	unclassified
ACCCACTTCTCGGACG-1	unclassified
ACCGTAAGTCCTAGCG-1	unclassified
ACCTTTAGTTCTGGTA-1	unclassified
ACCTTTAGTTGGTAAA-1	unclassified
ACGAGCCAGACAGAGA-1	unclassified
ACGAGCCAGCTATGCT-1	unclassified
ACGATGTAGAGCTATA-1	Enterocyte
ACGCCAGGTTTAGCTG-1	unclassified
ACGCCGACACTCTGTC-1	unclassified
ACGGGCTTCAAGCCTA-1	unclassified
ACGTCAACAGGCAGTA-1	unclassified
ACTGAGTTCCAGATCA-1	unclassified
ACTGATGTCCGTCATC-1	unclassified
ACTTACTCACGTGAGA-1	unclassified
AGAATAGGTGACAAAT-1	unclassified
AGAATAGGTGCCTGCA-1	unclassified
AGACGTTAGAACTCGG-1	unclassified
AGACGTTAGACTGGGT-1	unclassified
AGAGCGAAGTATGACA-1	unclassified
AGAGCGAGTTGGTGGA-1	unclassified
AGAGCGATCTGGCGAC-1	unclassified
AGAGCTTCAATCTGCA-1	unclassified
AGAGCTTTCACTTACT-1	unclassified
AGATCTGCAGATGGCA-1	unclassified
AGATCTGCATAGTAAG-1	unclassified
AGCAGCCAGACCACGA-1	unclassified
AGCATACGTCAAAGAT-1	unclassified
AGCCTAAAGCCACGTC-1	unclassified
AGCGTCGCAGATTGCT-1	unclassified
AGCTCTCGTATCAGTC-1	Enterocyte
AGCTCTCGTCCGAACC-1	unclassified
AGCTCTCGTGGCAAAC-1	unclassified
AGGCCACCACATGACT-1	unclassified
AGGCCACGTCTAGTCA-1	unclassified
AGGCCGTAGCGTGAAC-1	unclassified
AGGCCGTCACACGCTG-1	unclassified
AGGCCGTCATTAGGCT-1	unclassified
AGGGAGTAGCAGGCTA-1	unclassified
AGGGAGTAGCCTTGAT-1	unclassified
AGGGATGGTCTGATCA-1	unclassified
AGGGATGTCAAACAAG-1	unclassified
AGGGTGATCCTTGCCA-1	unclassified
AGTAGTCCACAGTCGC-1	unclassified
AGTAGTCCATGGTCTA-1	unclassified
AGTGGGACAAACTGTC-1	unclassified
AGTGTCACAGTGAGTG-1	unclassified
AGTGTCATCAACCAAC-1	unclassified
AGTGTCATCATATCGG-1	unclassified
ATAAGAGAGCGCTTAT-1	unclassified
ATCACGATCTGAAAGA-1	unclassified
ATCATGGGTCATATCG-1	unclassified
ATCATGGGTGAGGGTT-1	unclassified
ATCATGGTCTAACTGG-1	unclassified
ATCGAGTCAGCTTAAC-1	unclassified
ATCTGCCCATCGTCGG-1	unclassified
ATCTGCCGTACGCACC-1	unclassified
ATGAGGGAGACAGAGA-1	unclassified
ATGAGGGCACCACCAG-1	unclassified
ATGGGAGAGAGACTTA-1	unclassified
ATGGGAGCATTCCTGC-1	unclassified
ATTACTCTCTCAAGTG-1	unclassified
ATTCTACGTAGCCTCG-1	unclassified
ATTGGACTCACAGTAC-1	unclassified
ATTGGACTCCACTGGG-1	unclassified
ATTGGTGCATCACCCT-1	unclassified
ATTGGTGTCATGTAGC-1	unclassified
CAACCAACAATGTAAG-1	unclassified
CAACCAACACTAGTAC-1	unclassified
CAACTAGGTCCGTCAG-1	unclassified
CAAGAAATCCTTGACC-1	unclassified
CAAGATCGTGACGGTA-1	unclassified
CAAGATCGTGCAACGA-1	unclassified
CAAGGCCGTCCTCTTG-1	unclassified
CAAGTTGCACACCGAC-1	unclassified
CACAAACCACGTCAGC-1	unclassified
CACAAACGTCCGACGT-1	unclassified
CACACAAGTCGCATCG-1	unclassified
CACACCTAGTAGTGCG-1	unclassified
CACACTCAGATCCGAG-1	unclassified
CACACTCAGGCCCTCA-1	unclassified
CACACTCCAAGAGTCG-1	unclassified
CACAGGCAGCAGCGTA-1	unclassified
CACAGGCTCCGGCACA-1	unclassified
CACCACTCAGGCAGTA-1	unclassified
CACCAGGCACGACGAA-1	unclassified
CACCTTGAGAGCTTCT-1	unclassified
CACCTTGTCATCGCTC-1	unclassified
CAGAGAGCAACTTGAC-1	unclassified
CAGAGAGCACCCAGTG-1	unclassified
CAGAGAGCATTGAGCT-1	unclassified
CAGATCAAGAGTTGGC-1	unclassified
CAGCAGCCATCGGAAG-1	unclassified
CAGCCGAGTATAAACG-1	unclassified
CAGCTAAAGGTGACCA-1	unclassified
CAGCTAATCTAACTTC-1	unclassified
CAGTAACGTTCCGTCT-1	unclassified
CAGTAACTCAGTACGT-1	unclassified
CAGTCCTTCTTTAGGG-1	unclassified
CATATTCAGTCTCCTC-1	unclassified
CATCAAGTCTGGCGAC-1	unclassified
CATCAGAAGGAATGGA-1	unclassified
CATCAGACACCGAAAG-1	unclassified
CATCGAATCGAGAGCA-1	unclassified
CATGACAAGCGTGTCC-1	unclassified
CATTATCGTCTGCAAT-1	unclassified
CATTCGCAGGTAAACT-1	unclassified
CCACCTAGTGACAAAT-1	unclassified
CCACGGAAGAAACGAG-1	unclassified
CCACGGAGTCTCCCTA-1	unclassified
CCACGGATCTGTTTGT-1	unclassified
CCACTACTCACAGTAC-1	unclassified
CCAGCGATCCAAGTAC-1	unclassified
CCAGCGATCGTCTGAA-1	unclassified
CCATTCGAGAAGGCCT-1	unclassified
CCCAATCTCATGTGGT-1	unclassified
CCCTCCTCAATGGAAT-1	unclassified
CCGGGATAGCCAGAAC-1	unclassified
CCGGGATGTATAGGTA-1	unclassified
CCGGTAGTCTGCTGCT-1	unclassified
CCGTACTTCCACTCCA-1	unclassified
CCGTGGACAACAACCT-1	unclassified
CCGTGGACATCCGCGA-1	unclassified
CCTAAAGAGTGGACGT-1	unclassified
CCTAAAGGTGTTGAGG-1	unclassified
CCTACCACAGGACGTA-1	unclassified
CCTAGCTCAAGCGAGT-1	unclassified
CCTAGCTTCAAACAAG-1	unclassified
CCTCTGAGTAACGTTC-1	unclassified
CCTTACGGTATATGGA-1	unclassified
CCTTCGAGTAGCCTCG-1	unclassified
CCTTTCTAGAACTCGG-1	unclassified
CCTTTCTGTTGAGGTG-1	unclassified
CGACTTCAGAAACGCC-1	unclassified
CGACTTCAGGGATGGG-1	unclassified
CGAGCACCACGCTTTC-1	unclassified
CGAGCCATCCGCATCT-1	unclassified
CGAGCCATCCTCATTA-1	unclassified
CGATCGGCAGCTGTTA-1	unclassified
CGATGGCTCCGCAGTG-1	unclassified
CGATTGAAGTGAAGTT-1	unclassified
CGCCAAGTCAGAGACG-1	unclassified
CGCGTTTAGTCATGCT-1	unclassified
CGCTGGACACGAAAGC-1	unclassified
CGGACACGTCTGATCA-1	unclassified
CGGAGCTGTCTTTCAT-1	unclassified
CGGAGTCAGGCTCATT-1	unclassified
CGGCTAGCAACAACCT-1	unclassified
CGGTTAAAGAGAGCTC-1	unclassified
CGTAGGCGTGGTTTCA-1	unclassified
CGTCAGGTCACATACG-1	unclassified
CGTCCATGTGCACGAA-1	unclassified
CGTCCATTCACAACGT-1	unclassified
CGTCTACTCAACGCTA-1	unclassified
CGTGTAAAGATGGCGT-1	unclassified
CGTTCTGCAATTCCTT-1	unclassified
CGTTCTGGTCTGATCA-1	unclassified
CTAACTTAGACAAAGG-1	unclassified
CTAACTTCAAAGTCAA-1	unclassified
CTAACTTGTGAGTGAC-1	unclassified
CTAATGGAGGTGTTAA-1	unclassified
CTACACCGTGTAACGG-1	unclassified
CTACATTAGCGCCTTG-1	unclassified
CTACATTAGGGCTTGA-1	unclassified
CTAGAGTTCGATAGAA-1	unclassified
CTAGCCTAGTACGCCC-1	unclassified
CTAGCCTGTCTAACGT-1	unclassified
CTAGCCTTCAACGCTA-1	unclassified
CTAGTGAGTGGTCCGT-1	unclassified
CTAGTGATCTCTGCTG-1	unclassified
CTCACACTCCAACCAA-1	unclassified
CTCAGAACAGGGAGAG-1	unclassified
CTCCTAGAGCCCAGCT-1	unclassified
CTCCTAGTCTGGCGTG-1	unclassified
CTCGAAAGTTCCAACA-1	unclassified
CTCGGAGCAGCTCGCA-1	unclassified
CTCGGAGGTCATACTG-1	unclassified
CTCGGAGGTCATCCCT-1	unclassified
CTCGTACAGACGCACA-1	unclassified
CTCTAATTCTCGCTTG-1	unclassified
CTCTACGCATGTTCCC-1	unclassified
CTCTACGTCACATGCA-1	unclassified
CTGAAACAGTTGTCGT-1	unclassified
CTGAAACGTCGCTTTC-1	unclassified
CTGATAGCAATAGAGT-1	unclassified
CTGATCCGTGCACGAA-1	unclassified
CTGCCTAAGACTCGGA-1	unclassified
CTGCCTAGTCCAGTAT-1	unclassified
CTGCGGACAGTGGGAT-1	unclassified
CTGCGGATCTTGCCGT-1	unclassified
CTGTTTAAGGATGTAT-1	unclassified
CTGTTTAAGTACATGA-1	unclassified
CTTAACTTCACAATGC-1	unclassified
CTTACCGGTGCGATAG-1	unclassified
CTTAGGAGTAGCCTAT-1	unclassified
CTTTGCGGTACTCTCC-1	unclassified
CTTTGCGTCGGTCCGA-1	unclassified
GAAATGAAGTTCGCAT-1	unclassified
GAAATGAGTGATGTCT-1	unclassified
GAACATCCAATCCGAT-1	unclassified
GAACATCTCAACGGGA-1	unclassified
GAACGGAAGATGTCGG-1	unclassified
GACACGCAGCATGGCA-1	unclassified
GACACGCAGGGAGTAA-1	unclassified
GACACGCAGGGTGTTG-1	unclassified
GACAGAGAGATCGATA-1	unclassified
GACAGAGAGTCTCCTC-1	unclassified
GACCAATGTTGTGGCC-1	unclassified
GACCAATTCCATTCTA-1	unclassified
GACGTGCGTAGCGCAA-1	unclassified
GACGTGCTCGTATCAG-1	unclassified
GACTACAGTCCCTACT-1	unclassified
GACTACATCCCAAGAT-1	unclassified
GACTGCGGTCCGAGTC-1	unclassified
GAGCAGAAGGCCGAAT-1	unclassified
GAGCAGAAGTTAAGTG-1	unclassified
GAGTCCGTCCTCGCAT-1	unclassified
GATCGCGAGTAACCCT-1	unclassified
GATCGCGCATTAACCG-1	unclassified
GATCGCGGTCCAGTGC-1	unclassified
GATCGTAAGGTCGGAT-1	unclassified
GATCGTACACTAAGTC-1	unclassified
GATGAAACACTTCGAA-1	unclassified
GATGAAAGTCTCGTTC-1	unclassified
GATGAGGCACAACGCC-1	unclassified
GATTCAGTCAGCACAT-1	unclassified
GATTCAGTCTTGTATC-1	unclassified
GCAAACTAGGACAGAA-1	unclassified
GCAAACTCAATGAAAC-1	unclassified
GCAATCAAGCATGGCA-1	unclassified
GCACATACAGCCACCA-1	unclassified
GCAGCCACAACCGCCA-1	unclassified
GCATACATCACCAGGC-1	unclassified
GCATGATCAAAGGCGT-1	unclassified
GCATGCGTCAAACAAG-1	unclassified
GCCAAATAGTCAAGCG-1	unclassified
GCCTCTAGTCATCGGC-1	unclassified
GCGAGAAAGTCGAGTG-1	unclassified
GCGCAACCACGGCGTT-1	unclassified
GCGCCAATCTCATTCA-1	unclassified
GCGCGATCAGTCCTTC-1	unclassified
GCGGGTTAGTGACTCT-1	unclassified
GCGGGTTCATGCCTAA-1	unclassified
GCGGGTTGTGGTCCGT-1	unclassified
GCTCCTATCTTGACGA-1	unclassified
GCTCTGTCAAAGTCAA-1	unclassified
GCTCTGTGTCGGCTCA-1	unclassified
GCTCTGTGTTCCAACA-1	unclassified
GCTGCAGAGAGGTTAT-1	unclassified
GCTGGGTCAAGCGATG-1	unclassified
GGAAAGCTCCAGATCA-1	unclassified
GGAATAACATATGCTG-1	unclassified
GGAATAAGTCTGGTCG-1	unclassified
GGACATTAGGCGATAC-1	unclassified
GGACGTCAGTTGAGTA-1	unclassified
GGAGCAAAGCCACGTC-1	unclassified
GGATGTTTCCTTGCCA-1	unclassified
GGATTACAGGTCATCT-1	unclassified
GGATTACGTCTAACGT-1	unclassified
GGCAATTTCATCATTC-1	unclassified
GGCCGATAGATCCGAG-1	unclassified
GGCCGATAGCTGCAAG-1	unclassified
GGCCGATCAAACGCGA-1	unclassified
GGCCGATGTAAAGGAG-1	unclassified
GGCCGATGTCTTCGTC-1	unclassified
GGCGACTAGGCCCTTG-1	unclassified
GGCGTGTCACAGCCCA-1	unclassified
GGCGTGTGTATGCTTG-1	unclassified
GGCGTGTTCGTTACAG-1	unclassified
GGCTCGACAGTCCTTC-1	unclassified
GGGACCTTCTGTCCGT-1	unclassified
GGGAGATGTGTTGGGA-1	unclassified
GGGATGAAGATGCCAG-1	unclassified
GGGATGACACGACGAA-1	unclassified
GGGTCTGTCCGCGTTT-1	unclassified
GGTATTGAGTGCGATG-1	unclassified
GGTATTGCACGAGAGT-1	unclassified
GGTGCGTCATAACCTG-1	unclassified
GGTGCGTTCAGTTGAC-1	unclassified
GGTGTTATCCAGTAGT-1	unclassified
GTAACGTAGGATCGCA-1	unclassified
GTAACTGAGAATTCCC-1	unclassified
GTACTTTAGAATAGGG-1	unclassified
GTACTTTTCCTGTAGA-1	unclassified
GTACTTTTCGTCCGTT-1	unclassified
GTAGGCCAGGTCATCT-1	unclassified
GTAGGCCGTTCGAATC-1	unclassified
GTATCTTCACAAGCCC-1	unclassified
GTATCTTGTGCATCTA-1	unclassified
GTATCTTGTTAAAGAC-1	unclassified
GTATTCTTCGGTTCGG-1	unclassified
GTCAAGTCAGCCACCA-1	unclassified
GTCAAGTCATCGGGTC-1	unclassified
GTCACGGCACGAGAGT-1	unclassified
GTCGGGTCAAGTACCT-1	unclassified
GTGCAGCAGACTCGGA-1	unclassified
GTGCAGCTCCTAAGTG-1	unclassified
GTGCATATCATTGCCC-1	unclassified
GTGCGGTTCAAGGTAA-1	unclassified
GTGCTTCGTCAGAAGC-1	unclassified
GTGGGTCTCATTATCC-1	unclassified
GTTAAGCGTCCAGTAT-1	unclassified
GTTACAGGTCGAACAG-1	unclassified
GTTCTCGGTAAGTGTA-1	unclassified
TAAACCGCATCTATGG-1	unclassified
TAAGAGAAGCGTCTAT-1	unclassified
TAAGCGTTCTCTTATG-1	unclassified
TACAGTGCAATAAGCA-1	unclassified
TACAGTGCACAGACAG-1	unclassified
TACCTATTCATGTGGT-1	unclassified
TACCTTAGTTACTGAC-1	unclassified
TACGGATAGTGATCGG-1	unclassified
TACGGATCAGGGATTG-1	unclassified
TACGGTAGTTTGCATG-1	unclassified
TACTTGTAGGGCATGT-1	unclassified
TACTTGTAGTCACGCC-1	unclassified
TAGACCACACCATGTA-1	unclassified
TAGAGCTAGAAGGTGA-1	unclassified
TAGCCGGAGATGCCAG-1	unclassified
TAGCCGGGTTCAGCGC-1	unclassified
TAGGCATAGTTATCGC-1	unclassified
TAGTGGTAGTTGAGAT-1	unclassified
TATCTCAGTGAGCGAT-1	unclassified
TATCTCATCGTCCAGG-1	unclassified
TATGCCCCAGCCTGTG-1	unclassified
TATTACCGTTAGTGGG-1	unclassified
TCAATCTGTATATCCG-1	unclassified
TCACGAAAGGGCATGT-1	unclassified
TCACGAACAGTAAGCG-1	unclassified
TCAGCTCCAAGCCGCT-1	unclassified
TCAGCTCTCTCAAACG-1	unclassified
TCAGGATGTGAAATCA-1	unclassified
TCAGGATTCACTTACT-1	unclassified
TCAGGTACATTATCTC-1	unclassified
TCAGGTATCTTTAGTC-1	unclassified
TCATTACAGCGCCTCA-1	unclassified
TCATTACCACATAACC-1	unclassified
TCATTTGAGAGACTTA-1	unclassified
TCATTTGAGTAGTGCG-1	unclassified
TCCCGATAGTTGAGAT-1	unclassified
TCGCGTTAGATCCGAG-1	unclassified
TCGGGACCAGTGGGAT-1	unclassified
TCGGGACTCTTCTGGC-1	unclassified
TCGGTAACATGCCACG-1	unclassified
TCGTACCTCATGCAAC-1	unclassified
TCGTACCTCGCAAGCC-1	unclassified
TCTATTGGTACTCAAC-1	unclassified
TCTCTAACACAGAGGT-1	unclassified
TCTCTAAGTCACAAGG-1	unclassified
TCTCTAAGTCCTCCAT-1	unclassified
TCTCTAAGTTAGGGTG-1	unclassified
TCTTCGGTCAGTCCCT-1	unclassified
TGAAAGAAGACTAGGC-1	unclassified
TGAAAGAGTCCAACTA-1	unclassified
TGACAACAGACGCAAC-1	unclassified
TGACAACAGCTAGTGG-1	unclassified
TGACAACGTAAGTGTA-1	unclassified
TGACAACGTGCGAAAC-1	unclassified
TGACTAGTCCACTGGG-1	unclassified
TGAGAGGTCTCAACTT-1	unclassified
TGAGCCGCAGTTTACG-1	unclassified
TGAGCCGCATCGGAAG-1	unclassified
TGAGCCGGTGGCAAAC-1	unclassified
TGCACCTTCTGTGCAA-1	unclassified
TGCCAAACAAACGCGA-1	unclassified
TGCCAAACAAAGAATC-1	unclassified
TGCCAAATCAGGCCCA-1	unclassified
TGCCCTAAGTTCGCGC-1	unclassified
TGCCCTACAGCCTATA-1	unclassified
TGCGCAGGTTGACGTT-1	unclassified
TGCGGGTGTTGCGTTA-1	unclassified
TGCGGGTTCCAAAGTC-1	unclassified
TGCGTGGAGATCCTGT-1	unclassified
TGCTACCAGGTGCTTT-1	unclassified
TGCTACCAGTCCGGTC-1	unclassified
TGCTACCCAGTCAGAG-1	unclassified
TGGCCAGCAACGATCT-1	unclassified
TGGCGCAGTAAGGATT-1	unclassified
TGGGAAGCACACGCTG-1	unclassified
TGGGAAGCATCGATTG-1	unclassified
TGGTTAGAGGTCATCT-1	unclassified
TGGTTAGAGTTCGCAT-1	unclassified
TGGTTAGTCTGCTGCT-1	unclassified
TGGTTCCAGATGCCAG-1	unclassified
TGTATTCAGAGTTGGC-1	unclassified
TGTTCCGAGACACGAC-1	unclassified
TGTTCCGTCCCAAGTA-1	unclassified
TTAACTCCACCAGGCT-1	unclassified
TTAACTCCACCGCTAG-1	unclassified
TTAACTCTCACTTACT-1	unclassified
TTAGTTCGTGTATGGG-1	unclassified
TTATGCTCATTTGCCC-1	unclassified
TTCCCAGTCTCCCTGA-1	unclassified
TTCTACAAGATAGGAG-1	unclassified
TTCTCCTAGACAAGCC-1	unclassified
TTCTCCTGTCGGCACT-1	unclassified
TTGAACGAGCCTCGTG-1	unclassified
TTGCCGTCACTGTCGG-1	unclassified
TTGCCGTCAGCTATTG-1	unclassified
TTGCCGTTCGCGGATC-1	unclassified
TTGCGTCCAAACAACA-1	unclassified
TTGCGTCGTATTACCG-1	unclassified
TTGGAACCATGCGCAC-1	unclassified
TTGGAACGTCCGCTGA-1	unclassified
TTGTAGGGTCAAACTC-1	unclassified
TTGTAGGTCAGCACAT-1	unclassified
TTGTAGGTCATAAAGG-1	unclassified
TTGTAGGTCCGTCATC-1	unclassified
TTTACTGTCACGGTTA-1	unclassified
TTTGCGCAGACATAAC-1	unclassified
TTTGCGCAGATCCCGC-1	unclassified
TTTGGTTAGGTAAACT-1	unclassified
TTTGTCATCAACACCA-1	unclassified
AAACGGGCAGTGGGAT-1	Stem
AAAGATGAGCCTTGAT-1	Stem
AAAGATGTCCTAAGTG-1	Stem
AAAGTAGCACATGTGT-1	Stem
AACCATGAGCGTAATA-1	Stem
AACGTTGCACACCGCA-1	Stem
AACGTTGTCTCTTGAT-1	Stem
AACTCAGAGATAGGAG-1	Stem
AACTCCCTCACCCGAG-1	Stem
AACTCCCTCCATGAGT-1	Stem
AACTCTTCATTGTGCA-1	Stem
AACTTTCAGCTGCAAG-1	Stem
AACTTTCGTGAAAGAG-1	Stem
AAGACCTAGTTCGCAT-1	Stem
AAGCCGCTCCTCAATT-1	Stem
AAGCCGCTCTGTGCAA-1	Stem
AAGGCAGAGGAGTTGC-1	Stem
AAGGCAGGTTGAACTC-1	Stem
AAGTCTGGTAGCCTCG-1	Stem
AAGTCTGGTGACTCAT-1	Stem
AAGTCTGTCAGTTTGG-1	Stem
AATCCAGAGTTAACGA-1	Stem
AATCCAGTCGAATCCA-1	Stem
AATCGGTAGATGTAAC-1	Stem
AATCGGTAGGTGTGGT-1	Stem
AATCGGTTCTACTTAC-1	Stem
ACACCAAGTAAGTGTA-1	Stem
ACACCAATCCTCCTAG-1	Stem
ACACCCTCAGTATGCT-1	Stem
ACACCCTTCTGGGCCA-1	Stem
ACACCGGAGACACGAC-1	Stem
ACACCGGAGCAGGTCA-1	Stem
ACACCGGAGCCACGTC-1	Stem
ACACCGGGTAAGGATT-1	Stem
ACACCGGTCCAAATGC-1	Stem
ACACTGAGTCTTGATG-1	Stem
ACAGCTATCCATGCTC-1	Stem
ACAGCTATCGGCATCG-1	Stem
ACATACGAGGATGTAT-1	Stem
ACATCAGAGCCAGGAT-1	Stem
ACATGGTCAGTTAACC-1	Stem
ACCAGTAAGAGCAATT-1	Stem
ACCAGTAGTCTCAACA-1	Stem
ACCAGTATCCCACTTG-1	Stem
ACCGTAAAGTGTCTCA-1	Stem
ACCGTAAGTACCGCTG-1	Stem
ACCGTAATCTAACCGA-1	Stem
ACCTTTACATCGACGC-1	Stem
ACCTTTAGTTCCCTTG-1	Stem
ACGAGGACACCAGCAC-1	Stem
ACGAGGAGTAGCTAAA-1	Stem
ACGATACAGCAGCCTC-1	Stem
ACGATACAGTTACCCA-1	Stem
ACGCCAGGTATCAGTC-1	Stem
ACGCCAGTCACATGCA-1	Stem
ACGCCGAAGTCATGCT-1	Stem
ACGCCGATCATGCAAC-1	Stem
ACGGAGACATCCCACT-1	Stem
ACGGAGAGTAGAGCTG-1	Stem
ACGGCCAAGCGAGAAA-1	Stem
ACGGCCACACCAGGCT-1	Stem
ACGGGCTCAGCAGTTT-1	Stem
ACGGGCTCAGGAATGC-1	Stem
ACGGGCTTCCACGACG-1	Stem
ACTATCTAGCTACCTA-1	Stem
ACTATCTAGGGATACC-1	Stem
ACTATCTCATGAAGTA-1	Stem
ACTGAACAGGCTCAGA-1	Stem
ACTGAACCACACCGAC-1	Stem
ACTGAGTTCTTTCCTC-1	Stem
ACTGATGTCACTTACT-1	Stem
ACTGATGTCTCTTATG-1	Stem
ACTGATGTCTGTCCGT-1	Stem
ACTGCTCAGTTTAGGA-1	Stem
ACTGCTCCAAGCTGAG-1	Stem
ACTGCTCCACAAGCCC-1	Stem
ACTGTCCAGTGTACCT-1	Stem
ACTGTCCGTGACTCAT-1	Stem
ACTGTCCTCATAGCAC-1	Stem
ACTGTCCTCTCGAGTA-1	Stem
ACTTACTGTATATCCG-1	Stem
ACTTACTGTGCGCTTG-1	Stem
ACTTGTTAGCACAGGT-1	Stem
ACTTTCATCAGAAATG-1	Stem
ACTTTCATCTAACTGG-1	Stem
AGAATAGGTATGAATG-1	Stem
AGAATAGTCATCATTC-1	Stem
AGACGTTAGTAGCGGT-1	Stem
AGACGTTTCCCTTGCA-1	Stem
AGAGCGACACAAGCCC-1	Stem
AGAGCTTCACAGTCGC-1	Stem
AGAGTGGGTGACGGTA-1	Stem
AGATCTGAGGGATGGG-1	Stem
AGATTGCGTGCCTGCA-1	Stem
AGCATACGTGAGGGTT-1	Stem
AGCATACGTGCCTTGG-1	Stem
AGCCTAAAGCTATGCT-1	Stem
AGCCTAACAAGCGAGT-1	Stem
AGCGGTCCATGTCGAT-1	Stem
AGCGGTCTCTCCAACC-1	Stem
AGCGTATGTACATGTC-1	Stem
AGCGTATTCCACGACG-1	Stem
AGCGTATTCTAGCACA-1	Stem
AGCTCCTGTGATGATA-1	Stem
AGCTCTCCACGTAAGG-1	Stem
AGCTCTCTCATCTGCC-1	Stem
AGCTTGAAGGCATTGG-1	Stem
AGCTTGACAACTTGAC-1	Stem
AGCTTGAGTATGAAAC-1	Stem
AGGCCACAGACTCGGA-1	Stem
AGGCCACTCCGTAGGC-1	Stem
AGGGATGTCGATAGAA-1	Stem
AGGGTGACAATGCCAT-1	Stem
AGGGTGACAGCATGAG-1	Stem
AGGGTGACATCACCCT-1	Stem
AGGTCATCACAAGCCC-1	Stem
AGGTCATTCGCATGGC-1	Stem
AGGTCCGCAGGAATCG-1	Stem
AGGTCCGGTAGCTAAA-1	Stem
AGGTCCGGTGTAACGG-1	Stem
AGTAGTCTCGCGTAGC-1	Stem
AGTCTTTAGACGCAAC-1	Stem
AGTCTTTAGCTGCAAG-1	Stem
AGTCTTTGTACCGAGA-1	Stem
AGTCTTTGTCCGTGAC-1	Stem
AGTGAGGAGATGAGAG-1	Stem
AGTGGGATCGCGGATC-1	Stem
AGTTGGTGTAGAAAGG-1	Stem
AGTTGGTTCAAACCAC-1	Stem
ATAACGCCAGCTCGCA-1	Stem
ATAAGAGCAGATGAGC-1	Stem
ATAGACCCATGTCCTC-1	Stem
ATAGACCTCTGCGACG-1	Stem
ATCATCTAGACTTGAA-1	Stem
ATCATCTGTCTCAACA-1	Stem
ATCCACCCAGCATGAG-1	Stem
ATCCACCGTAAGTGGC-1	Stem
ATCTGCCAGTTAAGTG-1	Stem
ATCTGCCGTCAAGCGA-1	Stem
ATCTGCCGTCGCCATG-1	Stem
ATCTGCCGTTAAGTAG-1	Stem
ATGAGGGGTAAGGATT-1	Stem
ATGCGATCAGAAGCAC-1	Stem
ATGCGATGTATTCGTG-1	Stem
ATGCGATGTTCAGACT-1	Stem
ATGGGAGAGAGATGAG-1	Stem
ATGGGAGTCACTCTTA-1	Stem
ATGTGTGAGAAGGTGA-1	Stem
ATGTGTGAGTCCGGTC-1	Stem
ATTACTCCAAGCTGGA-1	Stem
ATTATCCGTTACGCGC-1	Stem
ATTATCCTCCTAGTGA-1	Stem
ATTCTACAGTACGATA-1	Stem
ATTCTACGTACTTGAC-1	Stem
ATTCTACGTTACAGAA-1	Stem
ATTGGACGTAAGTGGC-1	Stem
ATTGGACTCCTGTACC-1	Stem
ATTTCTGCATTACGAC-1	Stem
CAACCAAAGTGCGATG-1	Stem
CAACCAAGTGCGATAG-1	Stem
CAACCAAGTTAGAACA-1	Stem
CAACCTCCAGGAATCG-1	Stem
CAACCTCTCTACCTGC-1	Stem
CAACCTCTCTGTTTGT-1	Stem
CAAGAAAAGCTGCCCA-1	Stem
CAAGAAATCGGCTTGG-1	Stem
CAAGATCAGAGAGCTC-1	Stem
CAAGGCCTCGCGGATC-1	Stem
CAAGTTGAGTCCGTAT-1	Stem
CACAAACAGGACTGGT-1	Stem
CACAAACCAGCTCGAC-1	Stem
CACACAAGTGATAAGT-1	Stem
CACACCTAGTAGCCGA-1	Stem
CACACCTGTCCTCTTG-1	Stem
CACACCTTCCGCTGTT-1	Stem
CACACTCGTAAGCACG-1	Stem
CACACTCTCCGGGTGT-1	Stem
CACACTCTCTCACATT-1	Stem
CACACTCTCTGCCAGG-1	Stem
CACAGGCCACCTTGTC-1	Stem
CACAGTAAGGCCCTTG-1	Stem
CACAGTACAGCTGCAC-1	Stem
CACAGTATCAAGGTAA-1	Stem
CACATTTAGTAGTGCG-1	Stem
CACCTTGCAAGCTGGA-1	Stem
CACTCCATCCCTAATT-1	Stem
CAGAATCTCCATGAAC-1	Stem
CAGAGAGCAGTTTACG-1	Stem
CAGATCAAGCTTATCG-1	Stem
CAGATCACAGTAAGAT-1	Stem
CAGCAGCCACCAGGTC-1	Stem
CAGCAGCGTCCCTTGT-1	Stem
CAGCATACAGATCGGA-1	Stem
CAGCATAGTAAGTAGT-1	Stem
CAGCATAGTCCGTCAG-1	Stem
CAGCATAGTGTAATGA-1	Stem
CAGCCGATCGCCAAAT-1	Stem
CAGCGACAGTGTCCCG-1	Stem
CAGCGACCATTCTTAC-1	Stem
CAGCTAAAGAGGTTAT-1	Stem
CAGTAACAGAGGGATA-1	Stem
CAGTCCTCAGACTCGC-1	Stem
CAGTCCTCATGCGCAC-1	Stem
CATATGGCACGGCGTT-1	Stem
CATATTCCACAACGCC-1	Stem
CATATTCCACATTTCT-1	Stem
CATATTCTCTCTGTCG-1	Stem
CATCAAGCAGTGACAG-1	Stem
CATCAGATCTGCTGTC-1	Stem
CATCCACGTATATGAG-1	Stem
CATCCACGTCTAAACC-1	Stem
CATCCACTCTCCAGGG-1	Stem
CATGACATCGACAGCC-1	Stem
CATGCCTCAGGCTCAC-1	Stem
CATGCCTTCTCCGGTT-1	Stem
CATGGCGGTCCTCCAT-1	Stem
CATGGCGTCCATGCTC-1	Stem
CATGGCGTCTGCGACG-1	Stem
CATTATCAGAGCCTAG-1	Stem
CATTATCCACGTGAGA-1	Stem
CATTATCCATGATCCA-1	Stem
CATTCGCGTCTGGAGA-1	Stem
CCAATCCTCCGTAGGC-1	Stem
CCACCTAAGCCACGCT-1	Stem
CCACCTATCAGCGATT-1	Stem
CCACCTATCGTCCGTT-1	Stem
CCACCTATCTGCTGTC-1	Stem
CCACGGAAGGCTCTTA-1	Stem
CCACGGACATACAGCT-1	Stem
CCACTACCACTGTGTA-1	Stem
CCACTACCAGTATAAG-1	Stem
CCACTACTCCAGAGGA-1	Stem
CCAGCGAAGCCCGAAA-1	Stem
CCATTCGAGTCCGGTC-1	Stem
CCATTCGTCCATGAGT-1	Stem
CCCAGTTGTATCTGCA-1	Stem
CCCTCCTGTCAGAGGT-1	Stem
CCGGGATAGACTAGGC-1	Stem
CCGGGATGTTCTGGTA-1	Stem
CCGGGATTCCAACCAA-1	Stem
CCGGTAGCACCAACCG-1	Stem
CCGGTAGCACTTAAGC-1	Stem
CCGTACTAGGATGCGT-1	Stem
CCGTACTCAGCTCGAC-1	Stem
CCGTGGAAGTCCTCCT-1	Stem
CCGTGGAGTCCTCCAT-1	Stem
CCTAAAGTCAGCAACT-1	Stem
CCTAAAGTCCGGCACA-1	Stem
CCTAAAGTCTACTATC-1	Stem
CCTACACAGTAACCCT-1	Stem
CCTACACGTATAAACG-1	Stem
CCTACCAGTCATATGC-1	Stem
CCTAGCTAGAAACGAG-1	Stem
CCTAGCTGTGTGAAAT-1	Stem
CCTAGCTTCACCGTAA-1	Stem
CCTAGCTTCACTATTC-1	Stem
CCTAGCTTCCTTGGTC-1	Stem
CCTAGCTTCGCGATCG-1	Stem
CCTATTACAAACTGTC-1	Stem
CCTATTAGTTCATGGT-1	Stem
CCTTACGAGCCAGTTT-1	Stem
CCTTACGCACCAGGCT-1	Stem
CCTTACGGTTACTGAC-1	Stem
CCTTCCCAGAGTAATC-1	Stem
CCTTCCCAGGTGATTA-1	Stem
CCTTCGAAGTAGCGGT-1	Stem
CCTTTCTCACAGGCCT-1	Stem
CCTTTCTGTATCACCA-1	Stem
CCTTTCTTCTCAACTT-1	Stem
CGAACATGTACCATCA-1	Stem
CGAACATGTGACCAAG-1	Stem
CGAACATTCGCCCTTA-1	Stem
CGAATGTAGGATGGAA-1	Stem
CGACCTTTCATAGCAC-1	Stem
CGACTTCCACGCCAGT-1	Stem
CGAGAAGTCCGCGTTT-1	Stem
CGAGCACGTCGATTGT-1	Stem
CGAGCACTCAGAGCTT-1	Stem
CGAGCACTCTCAACTT-1	Stem
CGAGCCAAGGCCGAAT-1	Stem
CGAGCCAAGTGAATTG-1	Stem
CGATCGGTCCGCGTTT-1	Stem
CGATGGCTCGTCGTTC-1	Stem
CGATGTACATAGACTC-1	Stem
CGATGTACATGTTGAC-1	Stem
CGCCAAGCACATGGGA-1	Stem
CGCCAAGCAGGGATTG-1	Stem
CGCCAAGTCTGTGCAA-1	Stem
CGCGGTATCACCAGGC-1	Stem
CGCGTTTTCGATCCCT-1	Stem
CGCTATCAGATGGCGT-1	Stem
CGCTATCCAGTGGGAT-1	Stem
CGCTATCTCTTTACGT-1	Stem
CGCTGGAAGCGAAGGG-1	Stem
CGCTGGAAGCGTGAGT-1	Stem
CGCTGGAAGTGAATTG-1	Stem
CGCTGGAGTATTCGTG-1	Stem
CGCTGGATCATACGGT-1	Stem
CGCTTCACATAGGATA-1	Stem
CGCTTCAGTACAGTTC-1	Stem
CGGACACAGAGCCCAA-1	Stem
CGGACACAGATCCTGT-1	Stem
CGGACACAGGCCATAG-1	Stem
CGGACACTCCGCAGTG-1	Stem
CGGACGTCAGACAAAT-1	Stem
CGGACGTTCCAATGGT-1	Stem
CGGACGTTCCTGCCAT-1	Stem
CGGACTGAGGGAACGG-1	Stem
CGGACTGGTTTCGCTC-1	Stem
CGGAGCTTCTCGGACG-1	Stem
CGGAGTCAGATACACA-1	Stem
CGGCTAGAGCAGACTG-1	Stem
CGGCTAGAGGCTCTTA-1	Stem
CGGCTAGCACCGAAAG-1	Stem
CGGGTCACACTACAGT-1	Stem
CGGGTCATCATTATCC-1	Stem
CGGTTAAGTCTTGATG-1	Stem
CGTAGGCGTCGATTGT-1	Stem
CGTCACTCACCGAATT-1	Stem
CGTCAGGAGAAACCGC-1	Stem
CGTCTACTCTCCAGGG-1	Stem
CGTGAGCAGGCTCAGA-1	Stem
CGTGAGCTCCATGAGT-1	Stem
CGTGTAAGTCAGCTAT-1	Stem
CGTGTAAGTGCGGTAA-1	Stem
CGTTAGATCGCCATAA-1	Stem
CGTTCTGAGCCACGTC-1	Stem
CGTTCTGGTAGAGGAA-1	Stem
CGTTCTGGTCATCGGC-1	Stem
CGTTCTGGTTCCCGAG-1	Stem
CGTTCTGTCGCCGTGA-1	Stem
CGTTGGGAGAAACCTA-1	Stem
CGTTGGGGTGAAATCA-1	Stem
CGTTGGGGTTGACGTT-1	Stem
CGTTGGGTCAAAGACA-1	Stem
CTAACTTAGACAGGCT-1	Stem
CTAACTTCAACACGCC-1	Stem
CTAACTTGTAGGCTGA-1	Stem
CTAAGACCACAGGAGT-1	Stem
CTAATGGAGCGTTTAC-1	Stem
CTAATGGGTATCTGCA-1	Stem
CTAATGGGTGACTCAT-1	Stem
CTAATGGTCAAAGTAG-1	Stem
CTACACCAGTTGTCGT-1	Stem
CTACATTAGCGTTGCC-1	Stem
CTACATTGTTTCCACC-1	Stem
CTACATTTCTGAAAGA-1	Stem
CTACCCAAGACCGGAT-1	Stem
CTACCCAAGCCTTGAT-1	Stem
CTACCCACATGTTCCC-1	Stem
CTACCCAGTACAGACG-1	Stem
CTACCCATCATATCGG-1	Stem
CTACGTCTCGGAAACG-1	Stem
CTAGAGTAGTGCAAGC-1	Stem
CTAGCCTAGACGCAAC-1	Stem
CTAGTGACAGATGGCA-1	Stem
CTCACACAGACCGGAT-1	Stem
CTCACACAGCTAGTCT-1	Stem
CTCACACTCCAGGGCT-1	Stem
CTCAGAAAGCCCGAAA-1	Stem
CTCATTACACGCATCG-1	Stem
CTCATTATCCACTGGG-1	Stem
CTCCTAGCAAAGTCAA-1	Stem
CTCCTAGCAGCTTAAC-1	Stem
CTCCTAGTCAAGATCC-1	Stem
CTCCTAGTCGGATGGA-1	Stem
CTCGGAGCAATAGAGT-1	Stem
CTCGGAGCACAGGTTT-1	Stem
CTCGGAGGTGGTAACG-1	Stem
CTCGGAGGTTTGCATG-1	Stem
CTCGGAGTCAGCGATT-1	Stem
CTCGGAGTCGTATCAG-1	Stem
CTCGGAGTCTGAAAGA-1	Stem
CTCGGGACAAGTAATG-1	Stem
CTCGGGAGTAAACGCG-1	Stem
CTCGTACCATTCGACA-1	Stem
CTCTAATCAAGCTGAG-1	Stem
CTCTAATTCACAGTAC-1	Stem
CTCTACGCAATCTACG-1	Stem
CTCTACGCACTGCCAG-1	Stem
CTCTACGGTGGTTTCA-1	Stem
CTCTACGTCGCTAGCG-1	Stem
CTCTACGTCTATCGCC-1	Stem
CTGAAACGTCTAGTGT-1	Stem
CTGAAGTAGGATTCGG-1	Stem
CTGAAGTTCAGTACGT-1	Stem
CTGAAGTTCGAATGGG-1	Stem
CTGATAGGTGCAGACA-1	Stem
CTGATCCCAGGCTGAA-1	Stem
CTGCTGTCACAGATTC-1	Stem
CTGCTGTTCAGGCAAG-1	Stem
CTGGTCTAGCGAAGGG-1	Stem
CTGGTCTAGGTGCTAG-1	Stem
CTGGTCTGTCAAAGCG-1	Stem
CTGTGCTGTAAGCACG-1	Stem
CTGTGCTGTCTTTCAT-1	Stem
CTGTGCTGTTACGCGC-1	Stem
CTGTTTACAAACTGTC-1	Stem
CTGTTTAGTGCACGAA-1	Stem
CTGTTTAGTTATGCGT-1	Stem
CTGTTTATCGACAGCC-1	Stem
CTTAACTCACCCTATC-1	Stem
CTTAACTTCATATCGG-1	Stem
CTTAACTTCCACTCCA-1	Stem
CTTACCGAGGCTACGA-1	Stem
CTTACCGGTTCCACGG-1	Stem
CTTAGGAAGGACATTA-1	Stem
CTTAGGAGTGGTCTCG-1	Stem
CTTCTCTGTCCGTGAC-1	Stem
CTTCTCTTCAGGATCT-1	Stem
CTTCTCTTCTGGTTCC-1	Stem
CTTTGCGTCGCCAAAT-1	Stem
CTTTGCGTCTGAAAGA-1	Stem
GAAACTCCACATCCGG-1	Stem
GAAACTCGTGGTGTAG-1	Stem
GAAACTCTCCCTCAGT-1	Stem
GAAATGACAAGGACTG-1	Stem
GAAATGAGTCAGATAA-1	Stem
GAACATCTCGCATGAT-1	Stem
GAACCTATCGGCTTGG-1	Stem
GAACGGACAAAGGTGC-1	Stem
GAATGAACAGTCACTA-1	Stem
GACACGCGTGTTGGGA-1	Stem
GACCAATCAACGCACC-1	Stem
GACCTGGAGAGTGAGA-1	Stem
GACCTGGAGGCATGGT-1	Stem
GACCTGGCACTCAGGC-1	Stem
GACCTGGGTACTTCTT-1	Stem
GACCTGGTCGCAAACT-1	Stem
GACGGCTGTCGAGTTT-1	Stem
GACGGCTGTGTTAAGA-1	Stem
GACGTGCCAGTCGATT-1	Stem
GACGTGCCAGTCGTGC-1	Stem
GACTAACCATAGAAAC-1	Stem
GACTAACCATGAAGTA-1	Stem
GACTACACACTTAAGC-1	Stem
GACTACACAGTACACT-1	Stem
GACTGCGTCCCAAGTA-1	Stem
GACTGCGTCCTAGAAC-1	Stem
GAGGTGAAGCCAGGAT-1	Stem
GAGGTGAGTGCGGTAA-1	Stem
GAGGTGATCGGTGTCG-1	Stem
GATCAGTAGTGGTAAT-1	Stem
GATCGATTCTTGTTTG-1	Stem
GATCGCGCACGCGAAA-1	Stem
GATCGCGGTTAAAGTG-1	Stem
GATCGCGTCTTAACCT-1	Stem
GATCGTACAAGACGTG-1	Stem
GATCGTATCAGTGCAT-1	Stem
GATCTAGAGGCTACGA-1	Stem
GATGAGGAGCCACTAT-1	Stem
GATGAGGGTCCGAATT-1	Stem
GATGAGGGTGGCCCTA-1	Stem
GATGAGGTCCCTTGTG-1	Stem
GATGAGGTCTTACCGC-1	Stem
GATGCTACAAGGTGTG-1	Stem
GATGCTACATGTTCCC-1	Stem
GATTCAGAGCCAACAG-1	Stem
GATTCAGGTTTCGCTC-1	Stem
GCAAACTTCTGGAGCC-1	Stem
GCAATCAAGAGGTTAT-1	Stem
GCAATCAAGTAGCCGA-1	Stem
GCACATAAGCCAGAAC-1	Stem
GCACTCTCATATGCTG-1	Stem
GCACTCTTCCTGCAGG-1	Stem
GCAGCCAGTCATCCCT-1	Stem
GCAGTTAGTTTGTTTC-1	Stem
GCAGTTATCGCATGAT-1	Stem
GCATACAAGCGATGAC-1	Stem
GCATACACAGCTATTG-1	Stem
GCATACACATACGCCG-1	Stem
GCATACAGTCTGCCAG-1	Stem
GCATGATAGCGTCAAG-1	Stem
GCATGATAGTCACGCC-1	Stem
GCCAAATAGTACGCCC-1	Stem
GCGAGAAAGCGTCAAG-1	Stem
GCGAGAACACTCAGGC-1	Stem
GCGCAACGTGTCCTCT-1	Stem
GCGCAGTAGCTGGAAC-1	Stem
GCGCCAAAGATAGGAG-1	Stem
GCGCCAATCAGGCAAG-1	Stem
GCGCGATAGAGGTTGC-1	Stem
GCGCGATAGGGTATCG-1	Stem
GCGCGATTCAAACAAG-1	Stem
GCTCCTAAGACTTGAA-1	Stem
GCTCCTACACAGGCCT-1	Stem
GCTCCTACAGCATGAG-1	Stem
GCTCCTATCTGTCCGT-1	Stem
GCTCTGTCACCCATGG-1	Stem
GCTCTGTCAGCCTTGG-1	Stem
GCTCTGTCAGGGAGAG-1	Stem
GCTGCAGCAGCAGTTT-1	Stem
GCTGCAGTCTCCAGGG-1	Stem
GCTGCTTCACTACAGT-1	Stem
GCTGGGTCATTTGCTT-1	Stem
GCTGGGTGTTAAGATG-1	Stem
GCTTCCAGTGATAAGT-1	Stem
GCTTGAATCTCCAACC-1	Stem
GGAAAGCAGATTACCC-1	Stem
GGAAAGCAGCTGAACG-1	Stem
GGAAAGCAGTCAATAG-1	Stem
GGAACTTAGGGCATGT-1	Stem
GGAACTTAGGTTCCTA-1	Stem
GGAACTTGTGGACGAT-1	Stem
GGAACTTGTGTTAAGA-1	Stem
GGAATAACATACTACG-1	Stem
GGACAAGCATATGAGA-1	Stem
GGACAAGTCTTGCAAG-1	Stem
GGACAGACACCACGTG-1	Stem
GGACATTCATGTAGTC-1	Stem
GGACATTTCTGCCCTA-1	Stem
GGACGTCTCCAACCAA-1	Stem
GGAGCAAAGCCAGAAC-1	Stem
GGAGCAACACGGCTAC-1	Stem
GGAGCAACATGCCTTC-1	Stem
GGAGCAAGTATCACCA-1	Stem
GGAGCAATCCTTAATC-1	Stem
GGATTACTCTCCAGGG-1	Stem
GGCAATTGTTCGTCTC-1	Stem
GGCCGATCAGAAGCAC-1	Stem
GGCCGATGTTCTGTTT-1	Stem
GGCGACTAGGTTCCTA-1	Stem
GGCGACTCACGTAAGG-1	Stem
GGCGACTCAGATAATG-1	Stem
GGCGACTTCCCAAGTA-1	Stem
GGCGTGTCACCGAATT-1	Stem
GGCTCGACAAACAACA-1	Stem
GGCTCGAGTCTAAAGA-1	Stem
GGCTGGTAGAACTCGG-1	Stem
GGGAATGAGTGACATA-1	Stem
GGGAATGCAGCATGAG-1	Stem
GGGACCTTCCGAGCCA-1	Stem
GGGAGATAGCATGGCA-1	Stem
GGGAGATCACCACGTG-1	Stem
GGGAGATGTGTTAAGA-1	Stem
GGGAGATTCACGGTTA-1	Stem
GGGATGAAGTGGTCCC-1	Stem
GGGATGACATAGAAAC-1	Stem
GGGCACTCAATGAAAC-1	Stem
GGGCATCAGATAGTCA-1	Stem
GGGCATCTCCCTCAGT-1	Stem
GGGTTGCCACTTAACG-1	Stem
GGTGCGTCAGTTCCCT-1	Stem
GGTGCGTTCGGATGTT-1	Stem
GGTGCGTTCTAACGGT-1	Stem
GGTGTTACAGATTGCT-1	Stem
GGTGTTAGTGGACGAT-1	Stem
GTAACGTGTTCATGGT-1	Stem
GTAGGCCAGTTAGGTA-1	Stem
GTAGGCCCAGTGACAG-1	Stem
GTAGGCCTCCAAGCCG-1	Stem
GTAGGCCTCTTGCATT-1	Stem
GTAGTCAGTCGCGTGT-1	Stem
GTAGTCATCAGCAACT-1	Stem
GTAGTCATCATTATCC-1	Stem
GTCAAGTCACCTCGTT-1	Stem
GTCACAAAGAGTGAGA-1	Stem
GTCACGGGTGGCAAAC-1	Stem
GTCACGGTCACTCCTG-1	Stem
GTCATTTCAATCCGAT-1	Stem
GTCATTTCAATTCCTT-1	Stem
GTCATTTGTTCCACTC-1	Stem
GTCCTCAAGGCATGTG-1	Stem
GTCGGGTAGCGAAGGG-1	Stem
GTCGGGTCACTCAGGC-1	Stem
GTCGTAAAGGCCCGTT-1	Stem
GTCGTAAAGTCCGTAT-1	Stem
GTCGTAACACATAACC-1	Stem
GTCGTAAGTAGCACGA-1	Stem
GTCTCGTTCGACGGAA-1	Stem
GTCTCGTTCTATCGCC-1	Stem
GTGAAGGTCACCGTAA-1	Stem
GTGCAGCAGACATAAC-1	Stem
GTGCAGCCACGTAAGG-1	Stem
GTGCAGCGTGTTGAGG-1	Stem
GTGCATATCGCATGGC-1	Stem
GTGCATATCTCGTATT-1	Stem
GTGCATATCTTATCTG-1	Stem
GTGCGGTTCTAACTGG-1	Stem
GTGCTTCTCAGAAATG-1	Stem
GTGGGTCAGATATACG-1	Stem
GTGGGTCAGCAGATCG-1	Stem
GTGGGTCAGGCAGTCA-1	Stem
GTGGGTCGTCGCGAAA-1	Stem
GTGTGCGCATTGTGCA-1	Stem
GTGTGCGTCTTTAGGG-1	Stem
GTTAAGCCAATGGAGC-1	Stem
GTTAAGCTCCTGTACC-1	Stem
GTTACAGCATCGTCGG-1	Stem
GTTACAGCATGCAACT-1	Stem
GTTACAGGTATTAGCC-1	Stem
GTTCATTTCTTACCGC-1	Stem
GTTCGGGTCATGCATG-1	Stem
TAAACCGGTATAGGTA-1	Stem
TAAGAGATCACTTATC-1	Stem
TACAGTGAGTGAACAT-1	Stem
TACAGTGCAAATCCGT-1	Stem
TACAGTGTCCTTTACA-1	Stem
TACAGTGTCGTATCAG-1	Stem
TACCTATTCGTTACAG-1	Stem
TACCTTAAGGGCTTCC-1	Stem
TACCTTAGTATATGAG-1	Stem
TACCTTATCTCTGAGA-1	Stem
TACGGATAGAGATGAG-1	Stem
TACGGATAGTTCGATC-1	Stem
TACGGATGTCCGTCAG-1	Stem
TACGGATTCCACTCCA-1	Stem
TACGGATTCGCATGGC-1	Stem
TACGGATTCTTGTATC-1	Stem
TACTCATTCCAGGGCT-1	Stem
TACTCATTCGTAGATC-1	Stem
TACTCGCAGAACTGTA-1	Stem
TACTTACAGTTGCAGG-1	Stem
TACTTACCAATGCCAT-1	Stem
TACTTGTAGCTGATAA-1	Stem
TACTTGTGTCGTTGTA-1	Stem
TACTTGTTCTTCAACT-1	Stem
TAGACCACAATGGATA-1	Stem
TAGACCAGTAAAGGAG-1	Stem
TAGACCAGTAGTACCT-1	Stem
TAGAGCTCAACAACCT-1	Stem
TAGCCGGCACAAGACG-1	Stem
TAGCCGGTCCGCATCT-1	Stem
TAGGCATAGAGGTTAT-1	Stem
TAGGCATCAACACCTA-1	Stem
TAGGCATCAGTGGAGT-1	Stem
TAGTGGTAGCTGCAAG-1	Stem
TAGTGGTTCAGCACAT-1	Stem
TAGTGGTTCATCACCC-1	Stem
TAGTGGTTCTGTCTAT-1	Stem
TAGTTGGCAGCCTGTG-1	Stem
TATCAGGGTGCCTGCA-1	Stem
TATGCCCAGACTTTCG-1	Stem
TCAACGAAGGCGACAT-1	Stem
TCACGAAAGGGCTCTC-1	Stem
TCACGAAAGTTGTAGA-1	Stem
TCACGAATCGTAGGAG-1	Stem
TCAGATGGTTCGGGCT-1	Stem
TCAGCAACACAGGAGT-1	Stem
TCAGCTCAGAATGTGT-1	Stem
TCAGCTCCAAAGGAAG-1	Stem
TCAGCTCTCTTGCAAG-1	Stem
TCAGGATCACTATCTT-1	Stem
TCAGGTAGTGAGGGTT-1	Stem
TCAGGTAGTTACGCGC-1	Stem
TCATTACAGCGCTTAT-1	Stem
TCATTACCACGTCAGC-1	Stem
TCATTACCATCGGGTC-1	Stem
TCATTTGAGCGTTCCG-1	Stem
TCATTTGCATTCTTAC-1	Stem
TCATTTGGTCAGTGGA-1	Stem
TCCACACGTGGACGAT-1	Stem
TCCCGATAGGGTTCCC-1	Stem
TCCCGATCACCACCAG-1	Stem
TCGAGGCTCTCAACTT-1	Stem
TCGAGGCTCTGAGTGT-1	Stem
TCGCGAGGTTATCGGT-1	Stem
TCGCGTTCAGAGCCAA-1	Stem
TCGGGACAGTGTCCCG-1	Stem
TCGGTAAGTAAGAGAG-1	Stem
TCGGTAATCTCGAGTA-1	Stem
TCGGTAATCTGCTGCT-1	Stem
TCGTACCGTCTCAACA-1	Stem
TCGTACCTCGAGAACG-1	Stem
TCGTAGACAAGGTTTC-1	Stem
TCTATTGTCAATCACG-1	Stem
TCTATTGTCCAACCAA-1	Stem
TCTCTAATCAGCGACC-1	Stem
TCTGAGAAGACTAGAT-1	Stem
TCTGAGAAGCTAACTC-1	Stem
TCTGAGAAGCTGAACG-1	Stem
TCTGAGAAGGCACATG-1	Stem
TCTGAGAAGTTATCGC-1	Stem
TCTTCGGCAGGACGTA-1	Stem
TCTTCGGGTCTTGATG-1	Stem
TCTTTCCAGCCACGCT-1	Stem
TCTTTCCAGGCTAGGT-1	Stem
TCTTTCCAGGTGCTTT-1	Stem
TCTTTCCTCATGTCCC-1	Stem
TGAAAGAAGGGAAACA-1	Stem
TGAAAGAGTGGTACAG-1	Stem
TGACAACAGTACGACG-1	Stem
TGACGGCAGCGAAGGG-1	Stem
TGACGGCCAATCTGCA-1	Stem
TGACGGCGTTTAGCTG-1	Stem
TGACTAGAGTACTTGC-1	Stem
TGACTAGCAATACGCT-1	Stem
TGACTAGCATGGGACA-1	Stem
TGACTTTCAAGTTGTC-1	Stem
TGAGCATAGATGCCAG-1	Stem
TGAGCCGGTCGACTAT-1	Stem
TGAGGGATCAGCTTAG-1	Stem
TGATTTCAGAAACCGC-1	Stem
TGATTTCAGTGTACGG-1	Stem
TGATTTCGTCAACTGT-1	Stem
TGCCAAATCCGTTGTC-1	Stem
TGCCCTACAATTCCTT-1	Stem
TGCCCTACAGACGCAA-1	Stem
TGCCCTAGTTCACCTC-1	Stem
TGCGCAGCAGGTTTCA-1	Stem
TGCGGGTCAAACGTGG-1	Stem
TGCTACCAGAGCAATT-1	Stem
TGCTGCTCATGGTTGT-1	Stem
TGCTGCTGTGACTCAT-1	Stem
TGCTGCTTCCTCATTA-1	Stem
TGCTGCTTCGACGGAA-1	Stem
TGGACGCAGCCATCGC-1	Stem
TGGACGCCATGCCACG-1	Stem
TGGCCAGAGTAAGTAC-1	Stem
TGGCGCAAGAGAGCTC-1	Stem
TGGCGCACATACCATG-1	Stem
TGGGCGTCAGCTGTAT-1	Stem
TGGTTAGAGCAGCGTA-1	Stem
TGTATTCAGGAATCGC-1	Stem
TGTCCCACAACTGCGC-1	Stem
TGTGGTACATACGCCG-1	Stem
TGTGGTATCTGGCGTG-1	Stem
TGTGTTTGTGTGACGA-1	Stem
TGTGTTTTCAGTTTGG-1	Stem
TGTTCCGAGGGTGTGT-1	Stem
TGTTCCGGTCTTCGTC-1	Stem
TGTTCCGTCAACGGGA-1	Stem
TGTTCCGTCGTGGACC-1	Stem
TTAACTCAGATGTAAC-1	Stem
TTAACTCTCAACACTG-1	Stem
TTAGGACGTACCGCTG-1	Stem
TTAGGACTCAATAAGG-1	Stem
TTAGGACTCTCATTCA-1	Stem
TTAGGCAGTGCAGACA-1	Stem
TTAGGCATCTTAGCCC-1	Stem
TTAGTTCAGACTAAGT-1	Stem
TTAGTTCAGTTTGCGT-1	Stem
TTAGTTCTCTTCAACT-1	Stem
TTATGCTAGGGAACGG-1	Stem
TTATGCTTCGGAGGTA-1	Stem
TTCCCAGGTAAGTGTA-1	Stem
TTCCCAGTCCAAGCCG-1	Stem
TTCCCAGTCGCATGAT-1	Stem
TTCTACAAGTATCGAA-1	Stem
TTCTCAACAAGTAATG-1	Stem
TTCTCAATCATAAAGG-1	Stem
TTCTCCTTCGGAAATA-1	Stem
TTCTTAGAGAAACCAT-1	Stem
TTCTTAGAGATCCTGT-1	Stem
TTCTTAGGTGATAAGT-1	Stem
TTCTTAGTCATATCGG-1	Stem
TTGAACGGTATTACCG-1	Stem
TTGACTTGTAGGGTAC-1	Stem
TTGACTTGTCAGATAA-1	Stem
TTGACTTTCCATGAGT-1	Stem
TTGCCGTCACGAAACG-1	Stem
TTGCCGTCATCGATTG-1	Stem
TTGCGTCAGTACACCT-1	Stem
TTGCGTCCAAGCCGCT-1	Stem
TTGGCAAAGAGACGAA-1	Stem
TTGTAGGTCAAAGACA-1	Stem
TTTACTGCAATTCCTT-1	Stem
TTTACTGGTTCCTCCA-1	Stem
TTTATGCAGCTCAACT-1	Stem
TTTATGCAGTGACATA-1	Stem
TTTCCTCAGATGTAAC-1	Stem
TTTCCTCCACTTAAGC-1	Stem
TTTCCTCCAGGGTATG-1	Stem
TTTCCTCGTAAACCTC-1	Stem
TTTCCTCGTCACTTCC-1	Stem
TTTCCTCGTCCAGTTA-1	Stem
TTTCCTCTCCCTCAGT-1	Stem
TTTGCGCCACAAGACG-1	Stem
TTTGCGCCACAGCCCA-1	Stem
TTTGCGCTCTCTGCTG-1	Stem
TTTGGTTAGTCCATAC-1	Stem
TTTGTCAAGAGAACAG-1	Stem
AAAGATGAGGATATAC-1	unclassified
AAAGCAACACCTTGTC-1	unclassified
AACTGGTCATACTACG-1	unclassified
ACCAGTAGTCATGCCG-1	unclassified
ACTGAACTCCTGTACC-1	unclassified
AGAATAGTCCGCTGTT-1	unclassified
AGCAGCCCAATGGAGC-1	unclassified
AGCCTAAGTGCCTGCA-1	unclassified
AGTGGGACATATGGTC-1	unclassified
ATCACGACAAAGAATC-1	unclassified
ATCATGGGTTCCAACA-1	unclassified
ATCGAGTAGCGCCTTG-1	unclassified
ATGCGATCATTCTCAT-1	unclassified
ATGGGAGTCACCAGGC-1	unclassified
CAGCATAAGTACGTTC-1	unclassified
CATCAAGCATCCTAGA-1	unclassified
CATCAGAAGCCACGCT-1	unclassified
CCGTGGAAGTTAAGTG-1	unclassified
CGAGCACAGCTAGTTC-1	unclassified
CGATGTACAGGTGGAT-1	unclassified
CGCGGTACAAAGTGCG-1	unclassified
CGCTGGACAATGGATA-1	unclassified
CGTAGGCGTATCTGCA-1	unclassified
CGTCACTGTTCCATGA-1	unclassified
CGTTAGATCTATCCCG-1	unclassified
CGTTGGGCAAGTTGTC-1	unclassified
CTGAAACGTATATGAG-1	unclassified
CTGCCTACAAGCCTAT-1	unclassified
CTTACCGCAACTGCTA-1	unclassified
GAACCTATCTAAGCCA-1	unclassified
GACCAATCACTTACGA-1	unclassified
GACGGCTCACTTAACG-1	unclassified
GACTACAAGGCAGTCA-1	unclassified
GAGCAGACACGTCTCT-1	unclassified
GATCGATGTGGTGTAG-1	unclassified
GATCGCGTCTCTGCTG-1	unclassified
GCAGCCAAGCCAGTTT-1	unclassified
GCCTCTATCATCGGAT-1	unclassified
GCTCCTACATACTACG-1	unclassified
GGATGTTAGATACACA-1	unclassified
GGCGTGTCAAAGTGCG-1	unclassified
GGGCACTGTAAATACG-1	unclassified
GTACTTTGTAGGGACT-1	unclassified
GTAGGCCAGTCCCACG-1	unclassified
GTCGGGTAGGAATCGC-1	unclassified
GTCGTAACATTCCTCG-1	unclassified
GTCTCGTTCAACGGCC-1	unclassified
GTGTGCGTCAAGCCTA-1	unclassified
GTGTGCGTCAGCTCGG-1	unclassified
GTTCATTGTCAATACC-1	unclassified
TCAATCTAGGCGTACA-1	unclassified
TCAGATGTCTGCTGTC-1	unclassified
TCAGCTCAGGTCGGAT-1	unclassified
TGAAAGACACCGAAAG-1	unclassified
TGACGGCTCTGCAGTA-1	unclassified
TGCACCTTCTAGCACA-1	unclassified
TGCCCATCAGACAAGC-1	unclassified
TGCTACCGTCACCCAG-1	unclassified
TGGCTGGGTTATTCTC-1	unclassified
TGGTTCCCAAGGTGTG-1	unclassified
TTCTACAAGGGAGTAA-1	unclassified
TTCTCCTCAGCGTTCG-1	unclassified
TTGAACGAGGCAATTA-1	unclassified
AAAGATGTCTGCGTAA-1	unclassified
AAGTCTGGTTACGCGC-1	unclassified
AATCGGTAGGGTCGAT-1	unclassified
ACTTACTAGACACTAA-1	unclassified
AGATCTGTCAATCTCT-1	unclassified
AGCGGTCAGGCCCGTT-1	unclassified
AGCGTCGCATGAGCGA-1	unclassified
ATGGGAGAGCTAGTGG-1	unclassified
CACATAGTCGAACTGT-1	unclassified
CACATTTTCAAAGTAG-1	unclassified
CAGCAGCAGTGGAGTC-1	unclassified
CAGCATAGTACTCGCG-1	unclassified
CAGCGACAGAAGGTGA-1	unclassified
CAGGTGCGTACTTAGC-1	unclassified
CATCGAAAGAATCTCC-1	unclassified
CATCGGGTCCAAATGC-1	unclassified
CATTCGCAGTATCGAA-1	unclassified
CCGTACTCAGATCCAT-1	unclassified
CCTTCGAAGGTGACCA-1	unclassified
CGAGCACCACAGGCCT-1	unclassified
CGATGGCGTTCAGACT-1	unclassified
CGGAGTCTCATTGCCC-1	unclassified
CGTCTACGTGCTGTAT-1	unclassified
CGTTGGGGTCGCTTTC-1	unclassified
CTGAAACTCTTCATGT-1	unclassified
CTGAAGTTCGCATGAT-1	unclassified
CTTAACTTCCGAACGC-1	unclassified
GACCTGGCATGAACCT-1	unclassified
GACGTTAGTAGCCTCG-1	unclassified
GATGAGGCAGTATAAG-1	unclassified
GCAGCCAGTACCGCTG-1	unclassified
GCAGTTAGTAGCAAAT-1	unclassified
GCATACATCTACCTGC-1	unclassified
GCATGTAGTCCGTGAC-1	unclassified
GCCAAATTCGCAAGCC-1	unclassified
GCGCAACTCGGTGTTA-1	unclassified
GCGCAGTAGCTGTCTA-1	unclassified
GGCCGATCATATGCTG-1	unclassified
GGGCATCAGACTAGAT-1	unclassified
GGTGTTACATTAGCCA-1	unclassified
GTAACGTTCTAACTCT-1	unclassified
GTACGTACATCGGGTC-1	unclassified
GTAGTCACATCATCCC-1	unclassified
GTGCGGTAGAGTCGGT-1	unclassified
GTGTGCGTCTGCAGTA-1	unclassified
GTTAAGCTCCGGGTGT-1	unclassified
TACCTATAGAAGATTC-1	unclassified
TACCTATTCAACCAAC-1	unclassified
TCACAAGTCGTGGTCG-1	unclassified
TCAGCTCTCTGGAGCC-1	unclassified
TCAGGTAGTGCACGAA-1	unclassified
TCGCGTTCATCCCATC-1	unclassified
TCGGTAAAGGATGGTC-1	unclassified
TCTGGAAAGTAGCGGT-1	unclassified
TGCGCAGTCTACTCAT-1	unclassified
TTAGGACTCTCAACTT-1	unclassified
TTTCCTCCATACAGCT-1	unclassified
AAAGCAAAGAAACGAG-1	M
ACACCCTTCGGTGTCG-1	M
ACGCCGATCCGTCAAA-1	M
ACTGCTCCATGCCTTC-1	M
AGATCTGTCAGCACAT-1	M
ATCCGAAAGTCGATAA-1	M
CCAATCCGTTCAGCGC-1	M
CCTAAAGAGCTAGCCC-1	M
CCTACACCAAACCTAC-1	M
CGACTTCGTCCTAGCG-1	M
CTACACCTCTGCCAGG-1	M
CTACATTCATCTGGTA-1	M
CTCGTCACAGCTGTAT-1	M
CTCTACGGTTCCTCCA-1	M
GATCGATGTAATCACC-1	M
GATCGATGTCGGATCC-1	M
GCGCAACCATGGTTGT-1	M
GCGGGTTGTCTTCGTC-1	M
GGCGACTAGCTAACTC-1	M
GGCGACTGTGCCTGCA-1	M
GGGAGATCAATTGCTG-1	M
GTAGTCAAGGGTTCCC-1	M
GTTACAGCACATCCGG-1	M
GTTCATTAGAGTACCG-1	M
TAAGAGAGTAAGAGGA-1	M
TACACGATCGCATGGC-1	M
TACTCGCTCAAACCAC-1	M
TCAACGACATTTCAGG-1	M
TCAGCAACATGCATGT-1	M
TGAGCCGAGCCATCGC-1	M
TGGCGCAAGTTGTCGT-1	M
TTCTACAAGAATCTCC-1	M
TTCTCAAGTAGCAAAT-1	M
AGCTCTCTCTGCAAGT-1	Paneth
AGGTCATAGGCTATCT-1	unclassified
CAGATCACAGCTGGCT-1	unclassified
CCGTGGAAGGCCCTCA-1	unclassified
GACTACAAGGGTCTCC-1	unclassified
GATCGATTCAGATAAG-1	unclassified
GCCAAATCACATCCGG-1	unclassified
GTCGGGTAGCAGCCTC-1	unclassified
TGGCCAGGTGTTAAGA-1	unclassified
AATCGGTCATGCGCAC-1	unclassified
CACAAACGTTCAGACT-1	unclassified
CCTCTGAGTGCCTGTG-1	unclassified
CGCTGGAAGCTGAACG-1	unclassified
CGGACTGAGCGTGAAC-1	Enterocyte
GACGCGTTCTCTAGGA-1	unclassified
GAGGTGACAGCCTTTC-1	unclassified
GCATGCGGTCCGACGT-1	unclassified
GCGCAGTCACATAACC-1	unclassified
GCTGGGTTCCGAAGAG-1	unclassified
GGACAGACACTGAAGG-1	unclassified
GGTGAAGTCTTACCTA-1	unclassified
GTCATTTGTAGTGAAT-1	unclassified
TAAGCGTCATTCCTCG-1	unclassified
TACGGATAGTTACCCA-1	unclassified
TACGGTAGTGCTAGCC-1	unclassified
TACTTACCAAGTAGTA-1	unclassified
TTTGCGCAGTTAACGA-1	unclassified
CTGCGGATCTGATTCT-1	Enterocyte
TGATTTCGTGGAAAGA-1	Enterocyte
TGCCCATAGTTTCCTT-1	Enterocyte
TGCCCTAAGGGCTCTC-1	Enterocyte
AAGTCTGTCGTATCAG-1	Chief
ACCAGTAGTTCCGTCT-1	Chief
ACTGCTCTCGCCTGTT-1	Chief
AGATCTGTCTTGACGA-1	Chief
CACACAACAGGACGTA-1	Chief
CACATTTGTCAGTGGA-1	Chief
CATCAGAGTAAGTGGC-1	Chief
CCCAGTTGTGACAAAT-1	Chief
CGTCACTTCCGCGCAA-1	Chief
CTAACTTCAAGGACTG-1	Chief
CTCTGGTTCCCTTGTG-1	Chief
CTGATAGGTGCAGGTA-1	Chief
GAGCAGAGTAAATGAC-1	Chief
GCGCAGTAGTCTCGGC-1	Chief
GTGCTTCTCTGGTGTA-1	Chief
TAGACCAGTCACTTCC-1	Chief
TCACGAACACCGCTAG-1	Chief
TCGAGGCAGCTAGTGG-1	Chief
TGGGAAGCATATGGTC-1	Chief
TTGCCGTGTACACCGC-1	Chief
ACGATGTCAATACGCT-1	unclassified
AGACGTTGTGGGTCAA-1	unclassified
ATCTACTAGCGGATCA-1	unclassified
ATTATCCAGTATCGAA-1	unclassified
CAAGGCCGTAAGTTCC-1	unclassified
CACTCCACAGTAAGAT-1	unclassified
CGAGCACAGTGGACGT-1	unclassified
CGTTCTGGTCATTAGC-1	unclassified
CGTTCTGTCTCCGGTT-1	unclassified
GAATGAAAGCAAATCA-1	unclassified
GTACTCCTCCAAAGTC-1	unclassified
GTACTTTAGGCTAGCA-1	unclassified
GTGCAGCTCGCAAACT-1	unclassified
GTGCTTCGTTGTGGCC-1	unclassified
TCACGAAGTGTATGGG-1	unclassified
TCAGGATCACAAGTAA-1	unclassified
TCAGGATCACAGGAGT-1	unclassified
TCTGAGACAGCAGTTT-1	unclassified
TCTTTCCTCCGCGTTT-1	unclassified
TGACTAGAGATGGCGT-1	unclassified
TGACTAGAGGTGATTA-1	unclassified
TGGGAAGAGACTTTCG-1	unclassified
TTAACTCGTTATGTGC-1	unclassified
TTTCCTCGTTATTCTC-1	unclassified
