AAACCTGCACCTTGTC	T
AAACGGGAGTCCTCCT	N
AAACGGGTCCAGAGGA	T
AAAGATGCAGTTTACG	T
AAAGCAACAGGAATGC	T
AAAGCAATCGGAATCT	T
AAAGTAGAGTGTACTC	N
AAAGTAGCAGCCTATA	T
AAAGTAGGTACAGTTC	N
AAAGTAGTCGCATGAT	T
AAAGTAGTCTATCCCG	T
AAATGCCAGTACGTTC	T
AAATGCCCATTGGTAC	T
AAATGCCGTTGGTTTG	T
AACACGTTCTTAGAGC	T
AACCATGAGATGTCGG	T
AACCATGGTGTGGTTT	T
AACCATGTCACCACCT	T
AACCATGTCACCAGGC	T
AACCATGTCGTATCAG	N
AACCATGTCGTTTATC	T
AACCGCGCACCTATCC	T
AACCGCGGTGTCAATC	T
AACCGCGTCAAAGACA	T
AACGTTGTCGACCAGC	T
AACTCAGAGCTAGGCA	N
AACTCAGCAAGAAAGG	T
AACTCAGTCAGGATCT	T
AACTCAGTCCCAAGAT	T
AACTCCCCAAGCCCAC	T
AACTCCCCAGCAGTTT	T
AACTCCCGTAGGAGTC	T
AACTCCCGTGCACCAC	T
AACTCCCTCTCTAGGA	N
AACTCTTCAATAACGA	N
AACTCTTTCTTGTCAT	T
AACTGGTGTTTCCACC	N
AAGACCTCAGCTGCTG	T
AAGCCGCAGAAACCGC	N
AAGGAGCAGACAAGCC	T
AAGGAGCTCGAACTGT	T
AAGGCAGGTCACCTAA	T
AAGGCAGTCGCATGGC	N
AAGGTTCGTAGCGCTC	N
AAGGTTCGTTTAAGCC	T
AAGGTTCTCGAGCCCA	T
AAGTCTGCAGCTATTG	N
AAGTCTGCATCCGTGG	T
AATCCAGGTGCAACGA	T
AATCGGTTCGCATGGC	T
AATCGGTTCTCTAGGA	T
ACACCAAAGCACGCCT	T
ACACCCTAGAGCTTCT	T
ACACCCTGTAGCTAAA	N
ACACCGGCATGGTCTA	T
ACAGCTACACAGACTT	N
ACAGCTATCCAAGCCG	T
ACATCAGCAGTGACAG	T
ACCAGTAAGTTCGATC	T
ACCAGTACAGTTAACC	T
ACCAGTATCGTAGGAG	T
ACCCACTCATCGATGT	N
ACCCACTCATTGTGCA	T
ACCGTAAAGTATCTCG	T
ACCGTAACATGGAATA	T
ACCTTTACATCCGTGG	T
ACCTTTATCACCTTAT	N
ACGAGCCAGGCAAAGA	T
ACGAGCCTCCCTCAGT	T
ACGAGGACATGGTCTA	T
ACGATACGTCTAGTCA	T
ACGATACGTGACAAAT	N
ACGATACGTTGTTTGG	T
ACGATACTCCGTAGTA	T
ACGATGTTCTGTCAAG	N
ACGCAGCAGGCAATTA	T
ACGCAGCCAACACCCG	T
ACGCAGCCAGATAATG	N
ACGCAGCGTTCAACCA	T
ACGCCAGTCACAGTAC	T
ACGGAGAAGCAGGTCA	N
ACGGAGACATCCGTGG	T
ACGGCCAAGGGATGGG	N
ACGGCCACAAAGGAAG	T
ACGGCCACACTTAACG	T
ACGGCCAGTCAATACC	T
ACGGCCAGTTTGCATG	T
ACGGCCATCAGATAAG	T
ACGGCCATCCCTAACC	T
ACGGGCTAGCTGGAAC	N
ACGGGCTGTATAGGTA	T
ACGGGTCCACCAGATT	T
ACGGGTCCATACGCCG	T
ACGGGTCGTGTGAAAT	T
ACGTCAAAGACCTAGG	T
ACGTCAAGTGCAACGA	T
ACTATCTCAGTTTACG	T
ACTATCTGTAAGTGGC	T
ACTGAACAGATGCCTT	T
ACTGAACGTTCGTGAT	T
ACTGAACTCTTTAGTC	T
ACTGAGTAGCGGCTTC	T
ACTGAGTCATCGGAAG	N
ACTGAGTTCCCGACTT	N
ACTGATGGTCTCCACT	N
ACTGATGGTGAGTGAC	T
ACTGCTCAGGGCACTA	T
ACTGCTCCATACTACG	N
ACTGTCCGTAGAAAGG	T
ACTGTCCGTCATGCAT	T
ACTGTCCTCAAACGGG	T
ACTTACTAGTTTGCGT	N
ACTTACTCACGAAGCA	T
ACTTGTTAGTTCGCAT	N
ACTTGTTTCAGTACGT	T
ACTTTCACACAACTGT	T
ACTTTCACATGTCTCC	N
ACTTTCAGTGCTGTAT	T
ACTTTCATCCAGTAGT	T
AGAATAGAGAAGGCCT	T
AGAATAGAGAAGGGTA	T
AGAATAGTCAATCTCT	N
AGACGTTAGCACGCCT	T
AGACGTTAGCGTTGCC	T
AGACGTTGTAAAGTCA	N
AGAGCGACATTTGCCC	T
AGAGCTTTCGAACTGT	N
AGAGTGGTCACTCTTA	T
AGATCTGAGATGTGTA	T
AGATCTGCACAGCCCA	T
AGATCTGGTCCGAAGA	T
AGATCTGGTCTAGCCG	T
AGATTGCCACCACCAG	T
AGATTGCTCGTATCAG	N
AGATTGCTCTTGAGAC	T
AGCAGCCGTCCGACGT	N
AGCAGCCTCAGCTCTC	N
AGCAGCCTCGACAGCC	N
AGCAGCCTCTCCGGTT	T
AGCATACGTACCGAGA	N
AGCATACTCGTCACGG	T
AGCCTAAAGCTGCAAG	T
AGCCTAACAGCTGCTG	N
AGCCTAAGTCGCTTTC	T
AGCGGTCAGCTCCTCT	T
AGCGGTCTCATCTGTT	T
AGCGGTCTCGATGAGG	T
AGCGTATAGGACAGCT	T
AGCGTATGTTCAGACT	N
AGCGTCGAGGGATGGG	T
AGCGTCGAGTGATCGG	T
AGCGTCGTCGAGCCCA	T
AGCTCCTCACATCCGG	T
AGCTCTCCAGCCACCA	T
AGCTCTCTCAGCGATT	N
AGCTTGAGTTACGGAG	T
AGGCCACCAGTAAGCG	T
AGGCCGTAGTTCCACA	N
AGGCCGTTCCGTACAA	T
AGGGAGTTCACGAAGG	T
AGGGATGAGAAGATTC	T
AGGGATGCAATCCGAT	T
AGGGATGTCGCTTAGA	T
AGGTCATAGACACTAA	T
AGGTCATAGCAGACTG	T
AGGTCATAGCGTGAGT	T
AGGTCATGTATAAACG	T
AGGTCATGTGCTAGCC	T
AGGTCATTCTCTAAGG	T
AGGTCCGTCTGTCTCG	T
AGTCTTTAGCGCTTAT	N
AGTGAGGAGGTGCACA	N
AGTGGGAGTAGAGCTG	N
AGTGGGAGTCAATGTC	N
AGTGGGAGTCGAAAGC	N
AGTGGGAGTGGTCCGT	T
AGTGTCAAGACTAGGC	T
AGTGTCATCTGCTGTC	T
AGTTGGTAGACCACGA	N
AGTTGGTCAAGGTTTC	T
AGTTGGTCAGGACCCT	N
AGTTGGTGTCTGATTG	T
AGTTGGTTCCCTAATT	T
AGTTGGTTCGCCATAA	T
ATAACGCCACGTCAGC	T
ATAACGCCAGTGAGTG	T
ATAACGCGTGTGGTTT	N
ATAACGCTCCACTCCA	T
ATAACGCTCCGCATAA	N
ATAAGAGAGATATGGT	T
ATAAGAGCATGTAGTC	T
ATAAGAGTCCCTAATT	T
ATAAGAGTCTTGAGAC	T
ATAGACCAGCAGGTCA	T
ATAGACCCATCCTTGC	N
ATCATCTAGCTTATCG	T
ATCATCTGTTCCCGAG	T
ATCATCTTCGAGAACG	T
ATCATCTTCTGTGCAA	N
ATCATGGCACCACCAG	T
ATCATGGCACGACGAA	T
ATCCACCAGCGTAATA	T
ATCCACCAGGTGATAT	N
ATCCACCTCGAGAGCA	T
ATCGAGTAGGAACTGC	T
ATCGAGTAGTGTCCCG	T
ATCGAGTCAAGAGGCT	T
ATCTACTAGCACCGTC	T
ATCTACTAGCGCCTTG	N
ATCTACTGTGCTGTAT	N
ATCTGCCGTGGCGAAT	T
ATGAGGGAGTGTTTGC	T
ATGAGGGGTATGAAAC	N
ATGAGGGTCACTTATC	T
ATGAGGGTCTTAACCT	T
ATGCGATGTAGAGGAA	T
ATGCGATGTTCCGTCT	N
ATGGGAGGTAAGTGTA	T
ATGTGTGAGCGTTGCC	T
ATGTGTGAGGCGTACA	N
ATTATCCCAGCCAGAA	T
ATTATCCGTCTGCAAT	T
ATTCTACAGTGTCTCA	T
ATTCTACGTTTACTCT	T
ATTGGACGTCGGCTCA	T
ATTGGACGTTACGCGC	T
ATTGGTGCATGGGACA	T
ATTGGTGTCAGTCCCT	T
ATTTCTGAGGACCACA	T
ATTTCTGCAAAGCAAT	T
ATTTCTGGTCCATCCT	T
CAACCAACAAACTGTC	T
CAACCAACAATTCCTT	T
CAACCTCCATCACGTA	T
CAACCTCGTTGCTCCT	T
CAACCTCTCCTAGGGC	T
CAACTAGAGGTACTCT	T
CAAGAAAAGACAAAGG	T
CAAGAAACAAACTGTC	T
CAAGAAATCATAGCAC	T
CAAGATCAGCTCTCGG	N
CAAGATCAGGATCGCA	T
CAAGATCAGTCGTACT	N
CAAGATCCACCAGATT	N
CAAGATCCATGTCCTC	T
CAAGATCGTCGGCATC	T
CAAGATCTCGATCCCT	T
CAAGATCTCTAACTGG	T
CAAGATCTCTGTACGA	N
CAAGGCCGTGCGATAG	N
CAAGGCCTCGGTTAAC	T
CAAGTTGAGCTCCTCT	N
CACAAACCAAAGCAAT	T
CACACAACAAGTTCTG	T
CACACAACATTTGCTT	T
CACACAATCAGTCCCT	N
CACACAATCGTGGACC	T
CACACCTCAAGAAGAG	T
CACACCTTCTTACCGC	T
CACACTCAGGGCTTCC	N
CACACTCAGTCCTCCT	T
CACACTCCAACTGCTA	N
CACAGGCAGTACACCT	T
CACAGTAAGGTAAACT	N
CACAGTACAAACCCAT	T
CACAGTAGTAGAGTGC	T
CACAGTATCGGTTCGG	T
CACATAGGTGGTTTCA	N
CACCACTAGACTGTAA	T
CACCACTAGCTAAACA	N
CACCACTTCACAACGT	T
CACCACTTCCTCATTA	T
CACCAGGGTCGCATCG	T
CACCTTGCATTACCTT	T
CACCTTGGTACAGCAG	T
CACCTTGGTCTTCTCG	T
CACTCCACATGATCCA	T
CAGAATCAGGACAGAA	N
CAGAATCAGGATGCGT	T
CAGAATCTCCATGAAC	T
CAGAGAGCAGTATAAG	N
CAGCAGCAGGACGAAA	N
CAGCAGCCAATCTACG	N
CAGCAGCTCCCGACTT	T
CAGCCGAGTCTAGTCA	T
CAGCGACAGCATCATC	T
CAGCGACCACTCGACG	T
CAGCGACCATGCGCAC	N
CAGCTAAAGATGGGTC	T
CAGCTAAAGTACATGA	T
CAGCTAACAGGTGGAT	T
CAGCTAACATGCAATC	T
CAGCTAAGTAGTAGTA	T
CAGCTAAGTGCTAGCC	N
CAGCTAATCCACGACG	T
CAGCTGGAGAGGGATA	T
CAGCTGGAGGAACTGC	N
CAGCTGGGTACCGTAT	N
CAGGTGCAGCAGCCTC	N
CAGGTGCAGCGCCTCA	T
CAGGTGCAGTGACTCT	T
CATATGGAGACCACGA	T
CATATGGAGCCTTGAT	T
CATATGGAGGTGATAT	T
CATATGGCAAAGTCAA	T
CATATGGCACGAAACG	T
CATATGGGTCAAAGAT	N
CATATGGTCTCTTGAT	N
CATATTCGTACCGAGA	T
CATCAAGAGAGTGAGA	N
CATCAAGAGTCTCCTC	T
CATCAAGAGTCTTGCA	T
CATCAAGCAATCGGTT	T
CATCAAGGTGTGTGCC	N
CATCAGATCCTCGCAT	N
CATCCACCAAGCGCTC	T
CATCCACCAGCCTATA	T
CATCCACCAGGCTCAC	T
CATCGGGAGAATAGGG	N
CATCGGGAGCGTCAAG	T
CATCGGGAGTACTTGC	T
CATCGGGCAATGCCAT	T
CATCGGGTCACGGTTA	T
CATCGGGTCATACGGT	T
CATCGGGTCGGTGTTA	T
CATCGGGTCTCCTATA	T
CATGACAGTTGTACAC	T
CATGCCTGTCGAGTTT	N
CATGGCGTCTTTCCTC	T
CATTCGCTCCAGGGCT	T
CCAATCCAGGTGATAT	T
CCAATCCAGTTGTAGA	N
CCAATCCCATAACCTG	T
CCAATCCGTATATCCG	T
CCAATCCGTCTGCCAG	T
CCAATCCGTGTAATGA	T
CCACCTAAGGGTTCCC	T
CCACCTACAGTCGTGC	T
CCACGGAAGGAGTAGA	T
CCACGGACACTTAACG	T
CCACTACCAGGATTGG	T
CCACTACTCTATCCCG	T
CCAGCGAAGGCATGGT	N
CCAGCGACAGTCACTA	N
CCAGCGATCTGCTGCT	T
CCATGTCCACCACGTG	T
CCATGTCGTTCGTTGA	N
CCATTCGAGCTCTCGG	T
CCATTCGAGGTGCTTT	T
CCATTCGCATAGGATA	T
CCATTCGGTTAAAGAC	T
CCCAATCAGTGTGGCA	T
CCCAATCTCCGTACAA	T
CCCAGTTAGCTCCCAG	T
CCCAGTTCACCACGTG	T
CCCAGTTGTATAGGGC	N
CCCATACAGTCGTACT	T
CCCATACCATTTGCCC	T
CCCATACGTCTGGTCG	T
CCCTCCTCACTCTGTC	T
CCGGGATGTACTCGCG	T
CCGGGATTCCAGGGCT	N
CCGGTAGAGCGATAGC	N
CCGGTAGGTACCAGTT	T
CCGGTAGGTATGAATG	N
CCGGTAGGTCATCGGC	T
CCGGTAGTCAATCTCT	T
CCGGTAGTCCGATATG	T
CCGGTAGTCCTGCAGG	N
CCGTACTGTTCCGTCT	N
CCGTACTGTTCCTCCA	N
CCGTGGATCTGCCCTA	T
CCGTTCAAGATGTTAG	N
CCGTTCATCCCGGATG	T
CCGTTCATCCGGCACA	N
CCTAAAGAGGTCATCT	T
CCTAAAGCAATGCCAT	T
CCTAAAGCAATTCCTT	T
CCTAAAGCATGGAATA	T
CCTAAAGGTGATGTGG	N
CCTAAAGTCCGAACGC	T
CCTACACCAGATAATG	T
CCTACACGTAAGGATT	N
CCTACCATCTTCCTTC	N
CCTAGCTAGCCACGCT	T
CCTAGCTGTCACTGGC	T
CCTAGCTGTGTGACGA	N
CCTATTAAGTGGAGAA	T
CCTCAGTTCGGAATCT	N
CCTCTGATCATGCAAC	N
CCTTACGCACGAAACG	T
CCTTACGCACGGCTAC	T
CCTTACGCATAGAAAC	T
CCTTACGCATTCTCAT	T
CCTTCCCAGTTACCCA	T
CCTTCCCGTTGCGCAC	T
CCTTCCCGTTTGTTTC	T
CCTTCGACAACACGCC	T
CCTTCGACACCGGAAA	T
CCTTTCTCATCGGGTC	T
CCTTTCTGTAACGTTC	T
CGAATGTGTCTTCTCG	T
CGAATGTGTGACGCCT	T
CGAATGTGTGCTGTAT	N
CGACCTTCACCCTATC	T
CGACCTTCACCTATCC	N
CGACTTCTCTACCAGA	T
CGAGAAGAGAACTCGG	T
CGAGAAGAGCGCTCCA	T
CGAGCACCACCACCAG	N
CGAGCACTCAACTCTT	T
CGAGCCACACATGGGA	N
CGAGCCATCCCAAGTA	T
CGAGCCATCTTGCATT	T
CGATCGGCACGGTGTC	T
CGATCGGCATCTACGA	T
CGATCGGTCTGCGTAA	N
CGATGGCCACCAGTTA	T
CGATGTAAGAACTGTA	T
CGATGTAGTAAATGTG	T
CGATGTATCAGTGTTG	T
CGCCAAGAGAGTCGGT	T
CGCCAAGCAATCAGAA	T
CGCGTTTAGGTGATAT	T
CGCGTTTCACCGATAT	T
CGCGTTTTCATCGGAT	T
CGCTATCAGCTCTCGG	T
CGCTATCAGTACATGA	N
CGCTATCCAGCTTCGG	T
CGCTGGAGTAAATGAC	T
CGCTTCAGTGACGCCT	T
CGCTTCATCTCTTATG	N
CGGACGTTCCACGCAG	T
CGGACTGGTTTAGCTG	T
CGGACTGTCAGTTTGG	T
CGGAGCTCAATCTGCA	T
CGGAGTCAGCAACGGT	N
CGGAGTCCATGGTCTA	T
CGGAGTCTCAGTTGAC	T
CGGCTAGGTCCGAATT	T
CGGGTCAGTACCGGCT	T
CGGGTCATCATTGCGA	N
CGGTTAAAGGCAATTA	N
CGGTTAAGTTACCGAT	T
CGGTTAATCGCCATAA	N
CGGTTAATCTAGAGTC	T
CGTAGCGAGATGCCAG	T
CGTAGCGAGCGTGAAC	T
CGTAGCGAGGATTCGG	T
CGTAGCGCAAGCCGTC	T
CGTAGGCCATGTCCTC	T
CGTAGGCTCTGTCTCG	N
CGTCACTGTACAGTGG	N
CGTCACTGTTAAGGGC	T
CGTCACTTCTCCAACC	T
CGTCAGGAGCCGGTAA	T
CGTCAGGAGGGTGTTG	T
CGTCAGGTCAGAGCTT	T
CGTCCATCAGCTGCTG	N
CGTCCATCATGTCTCC	N
CGTCCATTCGTTGACA	T
CGTGAGCAGACTTGAA	T
CGTGAGCGTCAATGTC	N
CGTGAGCGTCCGAACC	T
CGTGTAACAAGCTGAG	T
CGTGTAACAGCGTAAG	T
CGTGTAACAGGCTGAA	N
CGTGTAAGTTAAGATG	T
CGTGTAATCAGTGTTG	N
CGTGTAATCGCCCTTA	T
CGTGTCTCATCGGGTC	T
CGTTAGAAGACACTAA	T
CGTTAGAAGCTGTTCA	T
CGTTAGACACCGAAAG	T
CGTTAGATCAAACAAG	T
CGTTAGATCAGCGACC	T
CGTTAGATCGTCCAGG	T
CGTTCTGAGTTGTCGT	N
CGTTCTGCACGAAGCA	T
CGTTCTGGTAAGAGAG	T
CGTTGGGAGACCCACC	T
CGTTGGGCAGTGGAGT	T
CGTTGGGCATGAAGTA	T
CTAACTTCATCATCCC	T
CTAACTTTCTCCAACC	T
CTAAGACAGAAACGAG	T
CTAAGACTCCCTAACC	T
CTAATGGCATACAGCT	N
CTAATGGGTATTAGCC	T
CTAATGGGTTCCTCCA	T
CTAATGGTCATTGCCC	T
CTACACCTCCTATGTT	T
CTACATTAGTAGATGT	T
CTACCCAGTCTCACCT	N
CTACGTCTCAATACCG	N
CTAGAGTTCTGCCAGG	T
CTAGCCTAGCAATCTC	T
CTAGCCTCAAGCCCAC	T
CTAGCCTCACCTCGGA	T
CTAGTGAAGAGGACGG	T
CTAGTGACAACCGCCA	N
CTAGTGATCCTCCTAG	T
CTCACACGTGTGGTTT	T
CTCACACTCAAGATCC	T
CTCACACTCACATGCA	T
CTCACACTCCTAGTGA	T
CTCAGAAAGCGGCTTC	N
CTCAGAAAGGGCTTGA	T
CTCAGAAGTGTGACGA	T
CTCATTACAGGCGATA	T
CTCATTAGTCTACCTC	T
CTCATTAGTCTAGCCG	T
CTCATTATCAGCTTAG	T
CTCCTAGAGGCATGGT	N
CTCCTAGAGTAGGCCA	T
CTCGAAAAGTTAGCGG	T
CTCGGAGGTCCGAATT	T
CTCGGGATCGTGGTCG	N
CTCGGGATCTGAGGGA	T
CTCGTACAGAGCAATT	T
CTCGTACCAGACGCTC	N
CTCGTCAGTCTAAAGA	T
CTCTAATAGGATCGCA	N
CTCTAATAGTGAATTG	T
CTCTAATGTTTAGCTG	T
CTCTACGAGTGTTTGC	N
CTCTACGCACTTGGAT	T
CTCTACGGTGACTACT	N
CTCTGGTAGTGCCATT	N
CTCTGGTCATTAACCG	T
CTCTGGTGTCGGCATC	N
CTCTGGTGTTAAGATG	T
CTCTGGTTCGTGGACC	N
CTGAAACAGAAACCTA	N
CTGAAACAGGCATTGG	T
CTGAAACGTCCAGTGC	T
CTGAAACTCATGTCCC	T
CTGAAACTCCTGCCAT	T
CTGAAGTGTGAAGGCT	N
CTGAAGTTCAACACTG	N
CTGAAGTTCCCATTTA	T
CTGATAGGTCCGTCAG	T
CTGATCCAGCCGATTT	T
CTGATCCGTAGTACCT	N
CTGCGGAAGAGTCGGT	T
CTGCGGATCGGCTACG	T
CTGCTGTGTAATCGTC	T
CTGCTGTGTAGCACGA	T
CTGGTCTTCGCTGATA	T
CTGTGCTGTGGGTCAA	N
CTGTGCTGTGTGACCC	T
CTTAACTAGAGGTTAT	T
CTTAACTAGGGTGTTG	T
CTTAACTTCAACGAAA	T
CTTACCGGTAGCGTAG	N
CTTACCGTCCATTCTA	T
CTTCTCTCAATCAGAA	N
CTTCTCTCAATGAAAC	T
CTTCTCTCAATGGAAT	T
CTTCTCTGTACGCACC	T
CTTCTCTGTGTATGGG	T
CTTGGCTAGCGCCTCA	T
CTTGGCTCAGTAGAGC	T
CTTGGCTGTTGAGTTC	T
CTTTGCGTCCGAAGAG	N
GAAACTCCACCCAGTG	T
GAAACTCGTCTGCCAG	T
GAAACTCTCATGCAAC	T
GAAATGAAGTACGCCC	T
GAACATCCAATGGTCT	T
GAACATCGTAATAGCA	T
GAACATCGTACCGTTA	T
GAACCTAGTCGCATCG	T
GAACCTATCAGAGACG	T
GAACCTATCGTTTATC	T
GAACGGAAGCCTATGT	T
GAACGGAAGGAATTAC	N
GAACGGAAGTTACCCA	N
GAATAAGAGATCCGAG	T
GAATAAGGTGAAGGCT	N
GAATAAGGTTATGTGC	N
GACACGCTCTCGCATC	T
GACAGAGAGCAGGCTA	T
GACAGAGGTGTCTGAT	T
GACAGAGTCAACACGT	T
GACCAATAGACTAAGT	N
GACCTGGAGGAGTACC	T
GACCTGGCACCTCGTT	T
GACGCGTGTGACCAAG	N
GACGGCTGTTGTTTGG	T
GACGGCTTCTACTATC	N
GACGTGCAGACGCACA	T
GACGTGCCACTACAGT	N
GACGTTAGTTACGCGC	T
GACGTTATCTGGAGCC	N
GACTAACTCCCATTAT	T
GACTAACTCGGAATCT	T
GACTACAGTCGTCTTC	T
GACTACATCATCGATG	T
GACTACATCCTTTCTC	N
GACTGCGCAATGCCAT	T
GAGCAGAAGCCCAGCT	T
GAGCAGAAGTGGCACA	T
GAGCAGACAATGACCT	N
GAGTCCGGTAATCACC	T
GAGTCCGGTCTTCAAG	T
GAGTCCGGTGGTAACG	N
GAGTCCGTCTGACCTC	N
GATCAGTGTAGGAGTC	T
GATCGATCATTTCACT	N
GATCGATGTAGTACCT	T
GATCGATTCACCGGGT	T
GATCGTAAGTACGACG	N
GATCGTAAGTAGTGCG	T
GATCGTACACGAAAGC	T
GATCGTACAGATCGGA	T
GATCGTAGTTCCCGAG	T
GATCTAGAGCTGCGAA	T
GATCTAGCAGTCAGCC	T
GATCTAGGTAGCAAAT	T
GATCTAGTCAAACCGT	N
GATCTAGTCTATCCCG	N
GATGAAATCAACACAC	T
GATGAGGCACAACGCC	N
GATGAGGTCTCTGTCG	T
GATGCTATCATCGGAT	T
GATTCAGGTCCATGAT	T
GATTCAGGTCTGATTG	T
GATTCAGGTTAAGATG	N
GATTCAGTCCTATTCA	T
GCAAACTAGCGTGAAC	N
GCAAACTTCAACACGT	T
GCAATCACAACTGCTA	T
GCACATAGTAACGCGA	T
GCACATAGTTCCGGCA	T
GCACTCTTCCATGAGT	T
GCACTCTTCCCTAATT	N
GCACTCTTCTCGCTTG	T
GCAGCCAAGGAGTTTA	T
GCAGCCAAGGGCTTGA	T
GCAGCCACATCCGGGT	N
GCAGCCACATTCTCAT	T
GCAGCCATCATCTGTT	T
GCAGTTAAGCTAACTC	N
GCATACAAGTACGTTC	N
GCATACACACATGACT	T
GCATACATCCACTCCA	N
GCATGATAGAGGACGG	T
GCATGATCACACCGAC	N
GCATGATGTATGCTTG	T
GCATGATGTCGCGAAA	T
GCATGATTCCGAAGAG	T
GCATGCGAGAGAGCTC	T
GCATGCGAGATCCTGT	N
GCATGCGAGTTCCACA	T
GCATGCGGTGCCTGTG	N
GCATGCGGTTTAGGAA	N
GCATGTACAATCGAAA	T
GCATGTAGTAGCTAAA	N
GCATGTAGTGTAATGA	T
GCCAAATAGAATGTTG	T
GCCAAATCATCCTTGC	N
GCCAAATTCCGTCAAA	T
GCGAGAACAAGACACG	T
GCGAGAACACGTTGGC	T
GCGAGAATCATGCAAC	T
GCGAGAATCGGTCTAA	T
GCGAGAATCGTCACGG	T
GCGAGAATCTGCGTAA	N
GCGAGAATCTGGTTCC	N
GCGCAACAGGCGCTCT	N
GCGCAACCACAACGTT	T
GCGCAACTCCAAAGTC	T
GCGCAGTAGCAGCGTA	N
GCGCAGTCATGCAACT	N
GCGCAGTGTATCACCA	N
GCGCAGTGTGGTAACG	T
GCGCAGTTCACAACGT	T
GCGCCAACAACTTGAC	N
GCGCCAAGTTAAGGGC	T
GCGCCAATCAAGAAGT	T
GCGCGATAGGGTATCG	N
GCGCGATAGTCCGTAT	N
GCGCGATCACATAACC	T
GCGCGATTCATTGCGA	T
GCGCGATTCTGTCTCG	N
GCGGGTTAGGATATAC	T
GCGGGTTAGGGAAACA	T
GCGGGTTGTCAAAGAT	T
GCTCCTAAGAGTAATC	N
GCTCCTAAGCTCCTCT	N
GCTCCTAAGGAGCGAG	N
GCTCCTAGTATTCTCT	T
GCTCCTATCAGTTAGC	T
GCTCTGTAGATCACGG	T
GCTCTGTCAAGAGTCG	T
GCTCTGTCATTCCTGC	T
GCTCTGTTCGATAGAA	T
GCTGCAGAGAAGGGTA	N
GCTGCAGCAAAGGTGC	T
GCTGCAGTCAGTACGT	T
GCTGCGAGTCTCTCTG	N
GCTGCGATCAGCAACT	T
GCTGGGTCACCACGTG	T
GCTGGGTCATATACGC	T
GCTGGGTGTGCCTTGG	N
GCTTCCACAGGTCCAC	T
GCTTCCATCGTCCAGG	T
GCTTCCATCTTTCCTC	T
GCTTGAAGTAGGCATG	T
GGAAAGCAGCTAACTC	T
GGAACTTAGATCTGAA	T
GGAACTTCAACTGCTA	T
GGAACTTCAATACGCT	T
GGAATAACAGTAAGAT	N
GGAATAATCCGTAGTA	T
GGACAAGGTAGCGTGA	T
GGACAAGGTGGCTCCA	T
GGACAGAAGTGAAGAG	T
GGACAGATCAAAGTAG	T
GGACAGATCACCTCGT	T
GGACAGATCAGTGTTG	T
GGACAGATCCAAACAC	T
GGACATTAGAACTCGG	T
GGACATTAGTCATGCT	T
GGACATTCAGGGCATA	T
GGACATTCATTACCTT	T
GGACGTCAGCACAGGT	T
GGACGTCCACAGCGTC	T
GGACGTCCACCGTTGG	N
GGACGTCGTCAACATC	T
GGACGTCTCCGTTGCT	T
GGACGTCTCCTAGGGC	T
GGAGCAAGTCCTCTTG	N
GGAGCAAGTCTAGTCA	T
GGAGCAATCCGAGCCA	T
GGATGTTGTCATCCCT	T
GGATTACAGCAATATG	T
GGCAATTAGCTGTCTA	T
GGCAATTAGTCCAGGA	N
GGCAATTAGTCGTACT	T
GGCCGATCAGCGTAAG	N
GGCCGATGTGCTTCTC	T
GGCGACTAGCTGTTCA	N
GGCGACTAGTACGCCC	T
GGCGACTAGTCCGTAT	T
GGCGACTGTGTAAGTA	N
GGCGACTTCTGGGCCA	N
GGCGTGTCACCGTTGG	T
GGCTCGAAGTAGCGGT	T
GGCTCGACAAGTAGTA	T
GGCTCGACACTGTGTA	T
GGCTCGATCATTATCC	T
GGCTCGATCGGTTAAC	T
GGCTGGTCACGGTAAG	T
GGGAATGTCGCGGATC	N
GGGACCTAGCAGCCTC	T
GGGACCTCATCCCATC	T
GGGACCTTCGACAGCC	T
GGGAGATAGATATGGT	T
GGGAGATAGCGTTTAC	T
GGGAGATCATACGCCG	N
GGGATGAAGAGGACGG	T
GGGATGACAAGGTTCT	T
GGGATGACACCAGGTC	T
GGGATGAGTTCTGTTT	T
GGGCACTAGCCTATGT	T
GGGCATCCATGCTAGT	T
GGGCATCCATTCCTCG	T
GGGCATCGTCGGCATC	T
GGGCATCGTGACGGTA	T
GGGTCTGAGGGCTCTC	T
GGGTCTGGTAGAGTGC	T
GGGTCTGTCATCATTC	T
GGGTTGCCAGCTCGCA	T
GGGTTGCCAGTCACTA	N
GGGTTGCGTACGCTGC	T
GGGTTGCGTGGCAAAC	T
GGTATTGCATCCTAGA	T
GGTATTGTCTGTCTAT	T
GGTGAAGGTCCAGTAT	T
GGTGCGTGTGGTCCGT	N
GGTGTTAGTAACGCGA	T
GTAACGTAGTGCTGCC	T
GTAACTGCACCAGTTA	T
GTAACTGGTACCGTAT	T
GTAACTGGTTAAAGTG	T
GTAACTGTCGCCTGAG	N
GTACGTACAGTAAGCG	N
GTACTCCAGGAATGGA	T
GTACTCCAGTCGTACT	N
GTACTCCCACAGACAG	T
GTACTTTCACGGTGTC	N
GTACTTTGTGAAAGAG	T
GTACTTTGTGTCGCTG	N
GTAGGCCAGCGTTCCG	N
GTAGGCCCAAGAGGCT	T
GTAGGCCGTAATCACC	T
GTAGGCCGTCGCCATG	T
GTAGTCACACTTAAGC	N
GTAGTCACATACAGCT	T
GTAGTCACATATGGTC	T
GTAGTCAGTTCCACAA	T
GTATCTTGTACTTGAC	N
GTATCTTTCTTGTACT	T
GTATTCTAGTGTACTC	T
GTATTCTCAGCCAGAA	T
GTCAAGTCACTTCGAA	N
GTCAAGTCAGACAAGC	T
GTCACGGAGCTGAACG	N
GTCACGGAGTTGCAGG	T
GTCACGGCACTCTGTC	N
GTCACGGGTCAGCTAT	T
GTCATTTCACCGAAAG	T
GTCCTCAAGACATAAC	T
GTCGGGTAGCAGGCTA	T
GTCGGGTGTGGGTCAA	T
GTCGGGTTCACAACGT	T
GTCGGGTTCGACAGCC	N
GTCGTAATCCGTAGTA	T
GTCGTAATCTAACTTC	N
GTCGTAATCTTTACGT	T
GTCTCGTGTTCAGACT	T
GTCTTCGAGCTCCTTC	T
GTGAAGGCAATGAATG	T
GTGAAGGGTCGCGAAA	T
GTGAAGGTCGTTTGCC	T
GTGCAGCAGAGTAATC	T
GTGCAGCAGGCATTGG	T
GTGCAGCCACCAGCAC	N
GTGCAGCGTTGTTTGG	T
GTGCAGCTCATGCATG	T
GTGCATACACCACCAG	T
GTGCATACACGCTTTC	N
GTGCTTCCACATCCGG	N
GTGCTTCTCAACACTG	T
GTGGGTCGTATTCTCT	T
GTGTGCGCAAAGTGCG	N
GTGTGCGTCGGAATCT	T
GTGTTAGCAATCTACG	T
GTGTTAGCACCCTATC	T
GTGTTAGGTTAGAACA	T
GTTAAGCCAATGTAAG	T
GTTACAGGTAATCGTC	T
GTTACAGGTACGACCC	T
GTTACAGGTCAAGCGA	T
GTTACAGTCTTGTTTG	T
GTTCATTAGAGACTAT	T
GTTCATTGTTATCGGT	N
GTTCGGGAGATGTCGG	T
GTTCGGGCACTTGGAT	T
GTTCTCGAGAAACCGC	N
GTTCTCGAGAGGTTGC	T
GTTCTCGCAATCACAC	T
GTTCTCGGTAATAGCA	T
GTTCTCGGTCCCTTGT	N
GTTTCTATCCGTAGTA	N
TAAACCGAGGAACTGC	T
TAAACCGCACGGATAG	T
TAAACCGCAGATTGCT	T
TAAACCGGTATATGAG	N
TAAACCGTCAAACCAC	T
TAAGAGATCTGAGTGT	T
TAAGCGTAGCCCAGCT	T
TAAGCGTCAGGCAGTA	T
TAAGCGTGTCTAACGT	T
TAAGTGCAGAATAGGG	T
TAAGTGCCAATCACAC	T
TACACGAAGTGAATTG	T
TACACGAAGTTAACGA	T
TACACGACACAAGCCC	T
TACACGAGTCAAAGAT	T
TACACGAGTTGAACTC	T
TACAGTGCAGACGCTC	T
TACAGTGGTAACGTTC	T
TACAGTGGTTCTCATT	T
TACCTATAGATGAGAG	N
TACCTATAGATGGCGT	T
TACCTATAGGACACCA	N
TACCTATCAGATGGGT	N
TACCTTAGTCAGAAGC	N
TACGGATCATTGGGCC	N
TACGGGCCACCACCAG	T
TACGGGCTCAATCACG	N
TACGGTAAGCGTAGTG	T
TACGGTATCAGTTAGC	T
TACTCGCAGGGTGTTG	N
TACTCGCGTTCCAACA	T
TACTTACAGACACGAC	T
TACTTACCAAGAGTCG	T
TACTTACGTTAAGAAC	T
TACTTACTCTGACCTC	T
TACTTGTAGAGGTAGA	T
TACTTGTCATGCCCGA	N
TACTTGTGTAGCGTCC	T
TACTTGTTCACTGGGC	T
TAGACCAAGACAGACC	T
TAGACCATCTCTGTCG	N
TAGAGCTTCCATGAGT	N
TAGCCGGCATAACCTG	T
TAGTGGTCAATGTAAG	N
TAGTTGGCACCGAAAG	N
TATCTCAGTCCTCTTG	N
TATGCCCCACCCATGG	T
TATTACCAGTACGATA	T
TATTACCGTTTAAGCC	T
TATTACCTCGATAGAA	T
TCAACGAGTTTGGCGC	N
TCAACGATCCGCATAA	T
TCAATCTAGTGTGGCA	T
TCAATCTCACGACTCG	T
TCACAAGCAGCTTAAC	N
TCACAAGTCGAATCCA	N
TCACAAGTCGTGGACC	N
TCACGAAAGTTAACGA	T
TCACGAACACAGGCCT	T
TCACGAAGTTTGTTGG	T
TCAGATGAGGTAAACT	N
TCAGATGGTTACGCGC	T
TCAGATGGTTGATTCG	T
TCAGCAAAGGCTATCT	T
TCAGCAACAGACGCCT	T
TCAGCAAGTACAGCAG	T
TCAGCAATCATATCGG	T
TCAGCTCCAAGAGGCT	T
TCAGCTCTCGTAGGTT	T
TCAGGATGTTCCATGA	T
TCAGGATTCCCAACGG	T
TCAGGTACACGAAGCA	T
TCAGGTACACGGTAGA	T
TCAGGTATCATACGGT	T
TCATTACAGTGCCATT	T
TCATTACCACTAAGTC	N
TCATTACGTACCAGTT	N
TCATTACGTACCTACA	N
TCATTACGTACGCACC	T
TCATTACTCGAATCCA	T
TCATTTGCAATCCGAT	N
TCCACACGTACTTCTT	T
TCCCGATAGGCTAGCA	N
TCCCGATGTCGCGGTT	N
TCGAGGCCACATTCGA	N
TCGAGGCCATTGGCGC	T
TCGCGAGAGAAGGTTT	N
TCGCGAGAGACATAAC	T
TCGCGAGAGATCGATA	T
TCGCGAGCACCTATCC	N
TCGCGAGCATGGATGG	T
TCGCGAGTCCGCTGTT	T
TCGCGTTCACCAGGCT	N
TCGCGTTGTGACCAAG	T
TCGCGTTTCGAATGCT	T
TCGGGACTCACTCCTG	T
TCGGTAAAGCAATCTC	T
TCGGTAAGTGACGGTA	T
TCGGTAAGTTTACTCT	T
TCGGTAATCCGCGCAA	T
TCGTACCCAAGTCTGT	N
TCGTACCGTCGAATCT	T
TCGTAGACAACAACCT	T
TCGTAGATCGCGTAGC	T
TCTATTGCAAACGCGA	T
TCTATTGGTGCGAAAC	T
TCTATTGTCATGTAGC	N
TCTCATATCGGTGTCG	T
TCTCTAAAGCGTAATA	T
TCTCTAAGTCAATACC	N
TCTGAGACAGTACACT	N
TCTGAGACATATGCTG	N
TCTGAGATCTAACTGG	N
TCTGGAACAGACAAGC	N
TCTGGAACAGTATGCT	N
TCTGGAACATGGTCTA	N
TCTGGAAGTCGGATCC	N
TCTTCGGGTGATGTGG	N
TCTTCGGGTTTGTGTG	T
TCTTTCCAGTACGACG	T
TCTTTCCAGTGGTCCC	T
TCTTTCCTCACCGTAA	T
TCTTTCCTCGGCGCTA	T
TGAAAGAAGCCACCTG	T
TGAAAGATCGAATGCT	N
TGACAACCACGCGAAA	T
TGACAACCACGGCTAC	T
TGACGGCTCCTAGTGA	N
TGACGGCTCTTTACAC	N
TGACTAGAGGCAGTCA	T
TGACTAGCAACACCCG	N
TGACTAGCACGTCTCT	T
TGACTTTAGATGTTAG	N
TGACTTTTCCGCATAA	T
TGAGAGGAGCTAACAA	N
TGAGAGGAGTATCGAA	T
TGAGCCGAGACAAGCC	T
TGAGCCGAGCACGCCT	T
TGAGGGAAGTTAAGTG	T
TGAGGGATCGTCGTTC	T
TGATTTCGTAACGTTC	T
TGATTTCTCACAGGCC	T
TGCACCTAGAGGTACC	T
TGCACCTGTCGCGGTT	T
TGCACCTTCAACACAC	N
TGCACCTTCAACACCA	N
TGCCAAAGTTAGAACA	T
TGCCCATAGCCTTGAT	T
TGCCCATGTACTTGAC	T
TGCCCATTCAGAGCTT	N
TGCCCTAAGACGACGT	T
TGCGCAGAGAGACTTA	T
TGCGCAGGTACCATCA	N
TGCGCAGGTATATGGA	T
TGCGCAGGTCTTCGTC	N
TGCGGGTTCATTGCGA	T
TGCGTGGAGCGAAGGG	T
TGCGTGGCATATGAGA	T
TGCGTGGGTACAGACG	T
TGCTACCAGATGTCGG	T
TGCTACCCACGAGGTA	T
TGCTACCTCTTACCTA	N
TGCTGCTCAAGCGAGT	T
TGCTGCTCACCCATTC	T
TGCTGCTGTCTAGAGG	T
TGGACGCAGAAGGTGA	T
TGGACGCCACCAACCG	T
TGGCCAGAGCAGGTCA	N
TGGCCAGCAGTATGCT	T
TGGCCAGGTCTCATCC	T
TGGCCAGTCAAAGTAG	N
TGGCCAGTCACAATGC	T
TGGCGCAAGAATAGGG	T
TGGCGCATCGAGAACG	T
TGGCTGGAGCACAGGT	T
TGGCTGGTCAGGCCCA	T
TGGGCGTAGTATCTCG	T
TGGGCGTGTTCCACGG	T
TGGGCGTTCAAAGACA	T
TGGTTAGGTCGGGTCT	T
TGGTTCCCATGCTAGT	T
TGGTTCCTCATGGTCA	T
TGTATTCCATGATCCA	T
TGTATTCTCTGAAAGA	T
TGTCCCACATGGTCTA	T
TGTGGTAAGAGCCTAG	T
TGTGGTAGTGTAAGTA	T
TGTGGTATCCATTCTA	N
TGTTCCGCACCTCGTT	T
TGTTCCGGTATGCTTG	N
TTAACTCGTTAAGGGC	N
TTAGGACAGCCAGTTT	T
TTAGGACAGTGAATTG	T
TTAGGACCACAGGCCT	T
TTAGGACGTGTATGGG	T
TTAGTTCAGATCCCGC	T
TTAGTTCAGCGATCCC	N
TTATGCTAGATGTCGG	N
TTATGCTGTTGATTGC	T
TTCGAAGAGTGACTCT	N
TTCGAAGCAATGGTCT	N
TTCGAAGTCAAACAAG	N
TTCGAAGTCACCTCGT	T
TTCGAAGTCAGGTAAA	T
TTCGAAGTCTTGCCGT	N
TTCGGTCAGTGGCACA	T
TTCGGTCTCCTGCAGG	T
TTCGGTCTCTGGCGAC	N
TTCTACAAGATGGGTC	T
TTCTACACAATACGCT	N
TTCTCAAAGCGTTGCC	N
TTCTCAAGTCCGAACC	T
TTCTCAATCGCCTGAG	N
TTCTCAATCTGATTCT	T
TTCTTAGGTTTGGCGC	T
TTCTTAGTCATTGCGA	T
TTGACTTCATATACCG	T
TTGACTTTCTTTAGGG	N
TTGCGTCAGAGACTTA	T
TTGCGTCAGGTAGCCA	N
TTGGAACAGGGCATGT	T
TTGGAACAGTAAGTAC	T
TTGGAACCACAGTCGC	N
TTGGAACCACCGTTGG	T
TTGGCAATCAGTTTGG	T
TTGGCAATCGTCTGAA	N
TTGGCAATCGTTTGCC	T
TTGGCAATCTTGTTTG	T
TTGTAGGAGAGCCCAA	N
TTGTAGGGTCGACTGC	N
TTGTAGGTCTTCAACT	T
TTTACTGAGGACGAAA	N
TTTACTGCATGCTAGT	N
TTTACTGGTACTCGCG	T
TTTATGCGTAAAGTCA	T
TTTATGCTCCTCATTA	T
TTTATGCTCTGTTGAG	T
TTTCCTCTCGGAAACG	T
TTTGCGCCAATCACAC	T
TTTGTCATCTTGTATC	T
