AAACCCAAGAATAGTC-1	Normal
AAACCCAGTAGATCCT-1	Normal
AAACCCAGTGGCACTC-1	VEGFA_GBM
AAACCCATCCAACACA-1	GFAP_GBM
AAACGAAAGTCATAGA-1	Normal
AAACGAACAGAGAAAG-1	Normal
AAACGAAGTGAGACCA-1	Normal
AAACGAATCAGCCTCT-1	Normal
AAACGCTCAGAGTAAT-1	Normal
AAACGCTCAGTCAGAG-1	Normal
AAACGCTCATACTGTG-1	MEGF11_GBM
AAACGCTGTTGCCGAC-1	Normal
AAACGCTTCCGAGATT-1	Normal
AAAGGATCAAAGACTA-1	GFAP_GBM
AAAGGATCATGTGCCG-1	MEGF11_GBM
AAAGGATGTATCCCTC-1	Normal
AAAGGATGTCGCAGTC-1	VEGFA_GBM
AAAGGATGTCGCCACA-1	Normal
AAAGGGCAGGATAATC-1	Normal
AAAGGGCCATTGGCAT-1	Normal
AAAGGGCGTTTCGGCG-1	VEGFA_GBM
AAAGGGCTCTCTGCCA-1	GFAP_GBM
AAAGGTAAGCGTTCCG-1	VEGFA_GBM
AAAGGTAAGTTCACTG-1	VEGFA_GBM
AAAGGTAGTCCACACG-1	GFAP_GBM
AAAGTCCAGCATTGTC-1	Normal
AAAGTCCCACGCGCAT-1	Normal
AAAGTCCGTAGCGTAG-1	MEGF11_GBM
AAAGTCCGTATCGCGC-1	Normal
AAAGTCCTCGTTCTGC-1	Normal
AAAGTGAGTGGTCCGT-1	VEGFA_GBM
AAAGTGAGTTGCGGAA-1	Normal
AAAGTGATCCCTCTTT-1	MEGF11_GBM
AAATGGAAGAGTTCGG-1	GFAP_GBM
AAATGGAAGATGCTGG-1	Normal
AAATGGAAGCCTGTCG-1	Normal
AAATGGAAGGCTCACC-1	Normal
AAATGGATCAAGTCGT-1	GFAP_GBM
AACAAAGAGGCTGAAC-1	Normal
AACAAAGCACGCAAAG-1	Normal
AACAAAGGTCAAAGCG-1	MEGF11_GBM
AACAAAGGTCGTAATC-1	GFAP_GBM
AACAAAGGTGTAGGAC-1	Normal
AACAAAGTCTAACGGT-1	Normal
AACAAAGTCTGGGTCG-1	MEGF11_GBM
AACAACCAGACTCAAA-1	Normal
AACAACCAGATCACTC-1	Normal
AACAACCAGCATCAAA-1	Clone_2nd
AACAACCTCATAGACC-1	Normal
AACAAGAGTACCATAC-1	Normal
AACACACAGTCAGGGT-1	Normal
AACACACGTCACGTGC-1	MEGF11_GBM
AACAGGGCAGCATTGT-1	Normal
AACAGGGCAGCTGCCA-1	Normal
AACAGGGCATTCTTCA-1	MEGF11_GBM
AACAGGGTCACTGCTC-1	Normal
AACCAACAGTATTGCC-1	Normal
AACCAACCAAACGTGG-1	Normal
AACCAACGTCTGATCA-1	GFAP_GBM
AACCAACGTGTTGCCG-1	Normal
AACCAACGTTCTCCAC-1	VEGFA_GBM
AACCAACTCCCTGGTT-1	Normal
AACCACAAGGTAGATT-1	Normal
AACCACACAGGCTTGC-1	MEGF11_GBM
AACCACAGTAGCACAG-1	MEGF11_GBM
AACCATGAGACTCGAG-1	Normal
AACCATGCACCAAATC-1	Normal
AACCATGGTCCACGCA-1	Normal
AACCATGGTGAGCGAT-1	VEGFA_GBM
AACCATGTCCACGTGG-1	Normal
AACCCAAAGCACGGAT-1	GFAP_GBM
AACCCAAAGGCTCTAT-1	Normal
AACCCAAAGTATGGAT-1	Normal
AACCCAAGTACAGTCT-1	Normal
AACCCAATCATGCCGG-1	Normal
AACCTGAGTGATTCAC-1	MEGF11_GBM
AACCTGATCATGCCAA-1	Normal
AACCTTTCAGCACAAG-1	VEGFA_GBM
AACCTTTTCAGCTTGA-1	Clone_2nd
AACGAAAAGATGGTAT-1	Normal
AACGAAAAGGTAAGAG-1	GFAP_GBM
AACGAAAGTATCGAAA-1	VEGFA_GBM
AACGGGACACGCGGTT-1	MEGF11_GBM
AACGGGACAGTCAGCC-1	Normal
AACGGGAGTCCACATA-1	Normal
AACGTCAAGTCATTGC-1	Normal
AACGTCACAATACCCA-1	Normal
AACGTCAGTAGGATAT-1	Normal
AACGTCAGTCGCGTTG-1	Normal
AACGTCAGTGTATTGC-1	GFAP_GBM
AACGTCAGTTTGGAAA-1	MEGF11_GBM
AACGTCATCCCGAAAT-1	Normal
AACGTCATCGCACGAC-1	Normal
AACGTCATCTATTGTC-1	VEGFA_GBM
AACTTCTAGGTGATCG-1	Normal
AACTTCTGTGAAGCTG-1	Normal
AACTTCTGTGTGCCTG-1	Normal
AAGAACAGTGTTTCTT-1	Normal
AAGAACATCACTCCGT-1	Normal
AAGAACATCGCGTGAC-1	Normal
AAGACAAAGAGCAAGA-1	Normal
AAGACAATCACTGGGC-1	Normal
AAGACTCAGATGGGCT-1	Normal
AAGACTCAGTCAGCCC-1	Normal
AAGACTCAGTTACGTC-1	Normal
AAGACTCGTAAGTAGT-1	VEGFA_GBM
AAGACTCGTACACGCC-1	GFAP_GBM
AAGACTCGTAGATCCT-1	Normal
AAGACTCTCCGCAGTG-1	Normal
AAGATAGCAGGACAGT-1	MEGF11_GBM
AAGATAGGTTCGTACA-1	Clone_2nd
AAGATAGGTTTCCATT-1	MEGF11_GBM
AAGATAGTCACTGTCC-1	VEGFA_GBM
AAGCATCCAAATCAGA-1	Normal
AAGCATCGTGACTAAA-1	MEGF11_GBM
AAGCATCGTGGTCCCA-1	Normal
AAGCCATAGGAGTATT-1	GFAP_GBM
AAGCCATAGGTGGCTA-1	Normal
AAGCCATCAAGTTCCA-1	MEGF11_GBM
AAGCGAGAGACGAGCT-1	GFAP_GBM
AAGCGAGAGGTATCTC-1	Normal
AAGCGAGCAGTCACGC-1	Normal
AAGCGAGGTCAGATTC-1	VEGFA_GBM
AAGCGAGGTCCTGGTG-1	Normal
AAGCGAGGTCGTGGTC-1	Normal
AAGCGAGTCGGATTAC-1	Normal
AAGCGAGTCTAAGGAA-1	GFAP_GBM
AAGGAATCAGACTGCC-1	Normal
AAGGAATTCAGTGTGT-1	VEGFA_GBM
AAGGTAAAGTGGTCAG-1	GFAP_GBM
AAGGTAACAGAAACCG-1	Normal
AAGGTAACAGGTTCGC-1	Normal
AAGGTAAGTACAACGG-1	Normal
AAGGTAAGTATCCCTC-1	Normal
AAGGTAATCACACCCT-1	Normal
AAGGTAATCACCTTAT-1	MEGF11_GBM
AAGTACCAGATGTTCC-1	Normal
AAGTACCCAACGGCTC-1	Normal
AAGTACCCAGTGGCTC-1	Normal
AAGTACCGTATAGGAT-1	Normal
AAGTACCGTATGAAGT-1	Normal
AAGTACCTCACCCTGT-1	VEGFA_GBM
AAGTCGTCATTGGCAT-1	Normal
AAGTCGTGTACGGATG-1	GFAP_GBM
AAGTCGTTCACTGTTT-1	Normal
AAGTCGTTCTAGCCTC-1	GFAP_GBM
AAGTGAACACTAGTAC-1	MEGF11_GBM
AAGTGAACAGCTTCGG-1	MEGF11_GBM
AAGTGAAGTCGCGTCA-1	Normal
AAGTGAAGTGTAAATG-1	MEGF11_GBM
AAGTGAAGTGTTCGTA-1	MEGF11_GBM
AAGTGAATCGCGCTGA-1	Normal
AAGTTCGAGTCCTGTA-1	Normal
AAGTTCGAGTTGCATC-1	Normal
AAGTTCGCACATAGCT-1	VEGFA_GBM
AAGTTCGGTGCGGTAA-1	Normal
AATAGAGCAGTATGAA-1	Normal
AATAGAGGTAAGTTGA-1	Normal
AATAGAGTCATTGCGA-1	Normal
AATCACGGTACATACC-1	Normal
AATCACGTCATTACTC-1	Normal
AATCGACAGATACAGT-1	MEGF11_GBM
AATCGACCACCATATG-1	VEGFA_GBM
AATCGACCAGGTCCGT-1	Normal
AATCGACTCGATTGAC-1	Normal
AATCGACTCGGTGTAT-1	Normal
AATCGACTCTCTCAAT-1	Normal
AATCGTGAGTTGTCGT-1	VEGFA_GBM
AATCGTGGTATCAAGA-1	Normal
AATGAAGAGCTTTCTT-1	Normal
AATGAAGCATAGGAGC-1	GFAP_GBM
AATGAAGTCCCGTGTT-1	MEGF11_GBM
AATGAAGTCGCTGACG-1	Normal
AATGAAGTCTCTCTTC-1	MEGF11_GBM
AATGACCAGAGCATCG-1	Normal
AATGACCAGGTTCTAC-1	GFAP_GBM
AATGCCAAGTCGTTAC-1	Normal
AATGCCACACTCTAGA-1	Normal
AATGCCACATTGCTGA-1	GFAP_GBM
AATGCCATCACTTGGA-1	Normal
AATGCCATCCAATCCC-1	VEGFA_GBM
AATGGAACACTGGACC-1	Normal
AATGGAATCTGAGAAA-1	Normal
AATGGCTGTGGAGGTT-1	Normal
AATGGCTTCATTTCGT-1	Normal
AATTCCTAGTCTGGTT-1	Normal
AATTCCTCATACATCG-1	Normal
AATTCCTTCACTGGTA-1	Normal
AATTTCCAGACAACTA-1	VEGFA_GBM
AATTTCCAGACGCTCC-1	MEGF11_GBM
AATTTCCAGCCTCCAG-1	GFAP_GBM
AATTTCCAGCTGCCAC-1	MEGF11_GBM
AATTTCCAGGGCCCTT-1	MEGF11_GBM
ACAAAGACAAATGGTA-1	GFAP_GBM
ACAAAGACACCTATCC-1	MEGF11_GBM
ACAAAGACACTCCTGT-1	Normal
ACAAAGACATATGCGT-1	MEGF11_GBM
ACAAAGAGTACTTGTG-1	GFAP_GBM
ACAAAGAGTATGTCCA-1	Normal
ACAAAGAGTCAAAGTA-1	Normal
ACAAAGAGTGGTCTTA-1	Normal
ACAACCAAGGGCAAGG-1	Normal
ACAACCACAAACGGCA-1	GFAP_GBM
ACAACCATCCCGTGAG-1	MEGF11_GBM
ACAAGCTCACACGCCA-1	Normal
ACAAGCTCACATAGCT-1	VEGFA_GBM
ACAAGCTCATATGGCT-1	Normal
ACAAGCTCATCGGTTA-1	VEGFA_GBM
ACAAGCTGTGGAGGTT-1	Normal
ACAAGCTTCAACGCTA-1	Normal
ACAAGCTTCATCTGTT-1	Normal
ACAAGCTTCCCATAGA-1	GFAP_GBM
ACACAGTGTGTCCTAA-1	MEGF11_GBM
ACACCAAAGATGTTAG-1	GFAP_GBM
ACACCAAAGCCGGAAT-1	Normal
ACACCAACAATGTCTG-1	Normal
ACACCAAGTCGAAACG-1	Normal
ACACCAAGTGGAAATT-1	Normal
ACACCAAGTTGGCCTG-1	GFAP_GBM
ACACGCGCATTGACCA-1	Normal
ACACGCGGTCCAGCAC-1	GFAP_GBM
ACACGCGGTTTCGTTT-1	Normal
ACACTGATCTGAGCAT-1	Normal
ACAGAAAAGACCAGAC-1	Normal
ACAGAAAAGAGAATCT-1	Normal
ACAGAAACACCAGTAT-1	Normal
ACAGAAACAGGGACTA-1	Normal
ACAGAAATCAGGTAAA-1	MEGF11_GBM
ACAGCCGAGGATTTAG-1	Normal
ACAGCCGAGTATGAGT-1	MEGF11_GBM
ACAGCCGGTTGTAGCT-1	Normal
ACAGCCGTCACAGAGG-1	Normal
ACAGGGAAGACATCCT-1	MEGF11_GBM
ACAGGGAAGACGATAT-1	Normal
ACAGGGAAGTCTGGAG-1	Normal
ACAGGGAGTCGTTGCG-1	MEGF11_GBM
ACAGGGAGTTTCTATC-1	VEGFA_GBM
ACAGGGATCGATTGAC-1	VEGFA_GBM
ACATCCCCATCACGGC-1	Normal
ACATCCCGTAGAGACC-1	Normal
ACATCCCGTGGTGATG-1	MEGF11_GBM
ACATCGAAGTTAGTGA-1	Normal
ACATCGACAATTGCGT-1	Normal
ACATCGACACTGGAAG-1	Normal
ACATCGAGTGTGTGTT-1	Normal
ACATCGAGTTACCTGA-1	Normal
ACATCGATCATTTGGG-1	MEGF11_GBM
ACATGCAAGAATACAC-1	Normal
ACATGCAAGCCGAATG-1	Normal
ACATGCAAGCGAATGC-1	MEGF11_GBM
ACATGCAGTGCCTGAC-1	Normal
ACATGCAGTTCACGAT-1	GFAP_GBM
ACATTTCAGATGGGCT-1	MEGF11_GBM
ACATTTCAGCCATTCA-1	VEGFA_GBM
ACATTTCAGGGCAAGG-1	Normal
ACATTTCCACAAAGTA-1	Normal
ACATTTCCAGCGTAGA-1	Normal
ACATTTCGTAGACACG-1	VEGFA_GBM
ACATTTCTCCAAATGC-1	Normal
ACCAAACAGATGTTAG-1	VEGFA_GBM
ACCAAACAGTCATCCA-1	GFAP_GBM
ACCAACAAGATAGTCA-1	Normal
ACCAACAAGTCCCAAT-1	Normal
ACCAACAGTGACACAG-1	GFAP_GBM
ACCAACATCCGTATAG-1	Normal
ACCAACATCGTAGGAG-1	Normal
ACCACAAAGACTGTTC-1	GFAP_GBM
ACCACAACAGAGTGTG-1	Normal
ACCACAAGTGCGACAA-1	VEGFA_GBM
ACCACAAGTTCGGTAT-1	VEGFA_GBM
ACCACAATCGGAGATG-1	Normal
ACCACAATCGTCTACC-1	MEGF11_GBM
ACCATTTAGACTTCGT-1	Normal
ACCATTTGTTCGGGTC-1	Normal
ACCATTTTCCTTATAC-1	Normal
ACCCAAAAGATTGACA-1	Normal
ACCCAAAAGTGTACAA-1	MEGF11_GBM
ACCCAAATCCTCTCTT-1	Normal
ACCCTCAAGACCGTTT-1	Normal
ACCCTCAGTATACCTG-1	GFAP_GBM
ACCCTCAGTTGTGTAC-1	VEGFA_GBM
ACCCTCATCCAAGCCG-1	GFAP_GBM
ACCCTCATCGCTCCTA-1	Normal
ACCCTTGAGCCATCCG-1	Normal
ACCCTTGAGTAGGAAG-1	Normal
ACCCTTGCACTCTCGT-1	Normal
ACCCTTGTCAAACTGC-1	Normal
ACCCTTGTCGACCACG-1	GFAP_GBM
ACCGTTCAGCTCGCAC-1	Normal
ACCGTTCAGGGTAATT-1	Normal
ACCGTTCCACACCTGG-1	Normal
ACCGTTCGTAGCTTGT-1	Normal
ACCGTTCTCGAGTACT-1	Normal
ACCGTTCTCGCTTACC-1	VEGFA_GBM
ACCGTTCTCGGAATTC-1	VEGFA_GBM
ACCTACCAGCTCCATA-1	Normal
ACCTACCAGGCACTCC-1	Normal
ACCTACCGTGGGACAT-1	Normal
ACCTACCTCCTCAGGG-1	GFAP_GBM
ACCTACCTCGTGGACC-1	Normal
ACCTACCTCTAGAACC-1	GFAP_GBM
ACCTGAAAGGCACTAG-1	Normal
ACCTGAACACCAACAT-1	Normal
ACCTGAAGTAGAGTTA-1	Normal
ACCTGAAGTCCAACGC-1	Normal
ACCTGAAGTCCGGACT-1	Normal
ACCTGAAGTCTAGGTT-1	Normal
ACCTGTCCAGTCTCTC-1	Normal
ACGATCAAGCCTGAGA-1	Normal
ACGATCACAATTTCCT-1	Normal
ACGATCACAGTAGGAC-1	Normal
ACGATCACAGTCTTCC-1	Normal
ACGATCATCATCGTAG-1	MEGF11_GBM
ACGATGTAGGGTCAAC-1	VEGFA_GBM
ACGATGTCACTCCGAG-1	VEGFA_GBM
ACGATGTCAGAGAAAG-1	Normal
ACGATGTTCGACACCG-1	Normal
ACGCACGAGCATTTGC-1	MEGF11_GBM
ACGCACGGTATCCTCC-1	Normal
ACGCACGGTTCCATTT-1	MEGF11_GBM
ACGCACGTCCACACAA-1	MEGF11_GBM
ACGCACGTCTCTCGCA-1	MEGF11_GBM
ACGGAAGAGGTAGATT-1	Normal
ACGGAAGTCATTGGTG-1	Normal
ACGGAAGTCCCATAGA-1	GFAP_GBM
ACGGGTCAGATAGCTA-1	Normal
ACGGGTCAGGCGCTCT-1	Normal
ACGGGTCCAAACTCGT-1	MEGF11_GBM
ACGGGTCCAAAGAACT-1	MEGF11_GBM
ACGGGTCCAGCGTGCT-1	Normal
ACGGGTCGTCGTTCAA-1	Normal
ACGGGTCGTGAGAACC-1	Normal
ACGGGTCGTTATCCAG-1	Normal
ACGGGTCTCTCTGCCA-1	Normal
ACGGTCGAGGATTTAG-1	Normal
ACGGTCGCAGGTTTAC-1	MEGF11_GBM
ACGGTCGGTCGACTTA-1	MEGF11_GBM
ACGGTCGGTCGCAGTC-1	Normal
ACGGTCGGTTAAGAAC-1	Normal
ACGGTCGGTTAGAGAT-1	Normal
ACGGTTAAGGCATTTC-1	Normal
ACGGTTACAGCGTGAA-1	MEGF11_GBM
ACGGTTAGTAGGAGTC-1	GFAP_GBM
ACGTAACAGCTGACCC-1	MEGF11_GBM
ACGTAACAGCTGTCCG-1	GFAP_GBM
ACGTAACGTCTCAAGT-1	Normal
ACGTAACGTGGACAGT-1	MEGF11_GBM
ACGTAACGTGGCGTAA-1	Normal
ACGTAACTCACACGAT-1	GFAP_GBM
ACGTAACTCCATTTGT-1	Normal
ACGTAACTCTCTCTTC-1	Normal
ACGTACAAGGCAGTCA-1	Normal
ACGTACACATCTCCCA-1	VEGFA_GBM
ACGTACAGTCAAGCCC-1	Normal
ACGTACATCACGAACT-1	VEGFA_GBM
ACGTACATCGAACCTA-1	VEGFA_GBM
ACGTAGTAGAGTTGAT-1	Normal
ACGTAGTCACTGCTTC-1	Normal
ACGTAGTGTACCCACG-1	Normal
ACGTAGTGTGACCTGC-1	Normal
ACGTCCTAGAGATCGC-1	Normal
ACGTCCTCAAATCGTC-1	Normal
ACGTCCTCACGCTGCA-1	VEGFA_GBM
ACGTCCTGTCTAACTG-1	Normal
ACGTCCTGTGATTAGA-1	Normal
ACGTCCTGTGCGCTCA-1	Normal
ACGTCCTTCGCTTGCT-1	Normal
ACGTTCCAGAGCCCAA-1	Normal
ACGTTCCAGCACGGAT-1	Normal
ACGTTCCAGGTTAAAC-1	Normal
ACGTTCCAGTAGCAAT-1	Normal
ACGTTCCCAAGGGTCA-1	MEGF11_GBM
ACGTTCCGTATCACGT-1	Normal
ACGTTCCGTTGACTAC-1	Normal
ACGTTCCTCAAAGGTA-1	GFAP_GBM
ACGTTCCTCGGATACT-1	Normal
ACGTTCCTCTGTAAGC-1	Normal
ACTACGAAGCACTCCG-1	Normal
ACTACGATCGAGAGCA-1	Normal
ACTACGATCTAGAACC-1	Clone_2nd
ACTACGATCTTACGTT-1	Normal
ACTATCTCAACTTGCA-1	Normal
ACTATCTCATTCTTCA-1	MEGF11_GBM
ACTATCTGTCCGTACG-1	Normal
ACTATGGAGAATCCCT-1	GFAP_GBM
ACTATGGAGGGAGGCA-1	Normal
ACTATGGAGGTGCATG-1	GFAP_GBM
ACTATGGAGTAAATGC-1	Normal
ACTATGGAGTATTGCC-1	Normal
ACTATGGAGTCACACT-1	GFAP_GBM
ACTATTCAGGCCCAAA-1	Normal
ACTATTCCATTGAAGA-1	Normal
ACTATTCGTACGACAG-1	MEGF11_GBM
ACTATTCGTGGCCACT-1	MEGF11_GBM
ACTCCCAAGAGGCGGA-1	Normal
ACTCCCAAGCGCCTAC-1	Normal
ACTCCCACATAGGCGA-1	Normal
ACTCCCAGTATTTCCT-1	Normal
ACTCCCATCACCATCC-1	Normal
ACTCTCGCAAATAAGC-1	MEGF11_GBM
ACTCTCGGTTTGCAGT-1	MEGF11_GBM
ACTCTCGTCCATTTAC-1	GFAP_GBM
ACTCTCGTCTACCACC-1	MEGF11_GBM
ACTGATGAGACTTGTC-1	Normal
ACTGATGAGAGTGTTA-1	Normal
ACTGATGCACTCGATA-1	MEGF11_GBM
ACTGATGCACTTGACA-1	VEGFA_GBM
ACTGATGCAGAGGGTT-1	Normal
ACTGATGGTCGCACAC-1	Normal
ACTGATGGTTCACGAT-1	Normal
ACTGATGTCCGTGACG-1	MEGF11_GBM
ACTGCAAAGTGGTTAA-1	Normal
ACTGCAACATATGAAG-1	Normal
ACTGCAACATCGATCA-1	Normal
ACTGCAAGTAAGCGGT-1	GFAP_GBM
ACTGCAAGTACAGTCT-1	MEGF11_GBM
ACTGCAAGTAGATCGG-1	VEGFA_GBM
ACTGCAAGTGATAGAT-1	Normal
ACTGCAAGTTCGGGTC-1	Normal
ACTGCAATCCTCTGCA-1	Normal
ACTGCAATCCTGCCAT-1	Normal
ACTGTCCAGAAAGCGA-1	MEGF11_GBM
ACTGTCCCACCACATA-1	Normal
ACTGTCCGTATCGCAT-1	MEGF11_GBM
ACTGTCCGTCTACGAT-1	Normal
ACTGTCCTCATGTCTT-1	Normal
ACTGTGAAGAGAGCGG-1	Normal
ACTGTGAAGTTCCATG-1	Normal
ACTGTGACACAAAGTA-1	MEGF11_GBM
ACTGTGAGTACCTTCC-1	Normal
ACTGTGAGTACGATTC-1	GFAP_GBM
ACTGTGAGTTTCGTTT-1	Normal
ACTGTGATCGCATTAG-1	Normal
ACTTAGGAGAGGATCC-1	GFAP_GBM
ACTTATCCACAACGCC-1	MEGF11_GBM
ACTTATCTCATATGGC-1	GFAP_GBM
ACTTATCTCTCGTCAC-1	Normal
ACTTCCGAGCGGTAGT-1	Clone_2nd
ACTTCCGAGGCTGGAT-1	Normal
ACTTCCGAGTATCTGC-1	Normal
ACTTCCGCAAGGTCTT-1	Normal
ACTTCCGGTACTCGAT-1	VEGFA_GBM
ACTTCGCAGATTGTGA-1	Normal
ACTTCGCAGCTGCGAA-1	Normal
ACTTCGCAGTTCTCTT-1	GFAP_GBM
ACTTCGCCACGACTAT-1	GFAP_GBM
ACTTCGCCAGAGATGC-1	MEGF11_GBM
ACTTCGCCAGTCTGGC-1	VEGFA_GBM
ACTTCGCTCATCGACA-1	Normal
ACTTCGCTCGGCCCAA-1	MEGF11_GBM
ACTTTCAAGCTAGTTC-1	Normal
ACTTTCACAATCGCAT-1	Normal
ACTTTCAGTGAGCCAA-1	GFAP_GBM
ACTTTGTCACGCGTGT-1	Normal
ACTTTGTCAGCGTAGA-1	Normal
ACTTTGTGTACAGAAT-1	Clone_2nd
ACTTTGTGTACGGATG-1	Normal
ACTTTGTTCATCCTAT-1	Normal
AGAAATGAGACGCAGT-1	VEGFA_GBM
AGAAATGAGATGGCAC-1	Normal
AGAAATGCAATGTTGC-1	Normal
AGAAATGGTGCAACGA-1	Normal
AGAAATGTCGCCTTGT-1	MEGF11_GBM
AGAACAACACATGACT-1	Normal
AGAACAAGTTAGAGTA-1	VEGFA_GBM
AGAACAATCGTCGGGT-1	Normal
AGAACCTCACGACAAG-1	Normal
AGAACCTGTCCCGTGA-1	Normal
AGAACCTTCCCGAATA-1	Normal
AGAAGCGCAAAGCGTG-1	Normal
AGAAGCGCACCTCGTT-1	MEGF11_GBM
AGAAGCGCAGCTGGTC-1	VEGFA_GBM
AGAAGCGCAGTCGAGA-1	Normal
AGAAGCGGTTTGATCG-1	Normal
AGAAGTACATTGACCA-1	Normal
AGAAGTAGTCTCAGAT-1	VEGFA_GBM
AGACAAAAGTAGCATA-1	Normal
AGACAAAGTAGGAGTC-1	MEGF11_GBM
AGACAAAGTCAGTCCG-1	Normal
AGACAAATCCCGATCT-1	Normal
AGACACTAGAGACAAG-1	Normal
AGACACTAGCCAACCC-1	GFAP_GBM
AGACACTAGCCTTCTC-1	Normal
AGACACTCAGCGGATA-1	Normal
AGACACTGTACTCGAT-1	MEGF11_GBM
AGACACTGTGTGGACA-1	Normal
AGACACTTCTGATTCT-1	MEGF11_GBM
AGACAGGAGAGTGACC-1	Normal
AGACAGGAGTCACTGT-1	Normal
AGACAGGCAACGATCT-1	Normal
AGACAGGCACCAAATC-1	Normal
AGACAGGGTGAATAAC-1	Normal
AGACCATAGCGATGAC-1	Normal
AGACCATAGGATTACA-1	MEGF11_GBM
AGACCATGTAATGTGA-1	Normal
AGACCATGTTATCTGG-1	Normal
AGACCATTCGCCAACG-1	Normal
AGACCATTCGTAGTCA-1	GFAP_GBM
AGACCATTCTGGGTCG-1	Normal
AGACCCGAGCAACCAG-1	Normal
AGACCCGAGCACTTTG-1	Normal
AGACCCGAGGCAGTCA-1	Normal
AGACCCGAGGTCCCGT-1	GFAP_GBM
AGACCCGAGTCCCGAC-1	GFAP_GBM
AGACCCGGTTGTCTAG-1	MEGF11_GBM
AGACTCAAGGTTCAGG-1	MEGF11_GBM
AGACTCACACGAGAAC-1	Normal
AGACTCAGTCTGTAAC-1	MEGF11_GBM
AGAGAATAGAGCCGTA-1	GFAP_GBM
AGAGAATAGGTGGTTG-1	Normal
AGAGAATCAATAAGGT-1	GFAP_GBM
AGAGAATCAGGTGAGT-1	Normal
AGAGAATTCATTGGTG-1	VEGFA_GBM
AGAGAGCAGCGACAGT-1	Normal
AGAGAGCGTTGGCTAT-1	Normal
AGAGCAGTCAGAACCT-1	Normal
AGAGCAGTCGTCAACA-1	MEGF11_GBM
AGAGCCCAGAACGTGC-1	Normal
AGAGCCCCAGTGGCTC-1	MEGF11_GBM
AGAGCCCGTGGTCCGT-1	Normal
AGAGCCCTCTGGCCGA-1	Normal
AGATAGAAGTGAGCCA-1	Normal
AGATAGACACAGCGCT-1	MEGF11_GBM
AGATAGACATAACAGA-1	MEGF11_GBM
AGATAGAGTACCCACG-1	MEGF11_GBM
AGATAGATCGGCTTGG-1	VEGFA_GBM
AGATCCAAGTCAACAA-1	Normal
AGATCCACAACGGCTC-1	Normal
AGATCCACATAACTCG-1	Normal
AGATCCAGTCACCGCA-1	Normal
AGATCCAGTGGTCTAT-1	MEGF11_GBM
AGATCCATCACTACGA-1	GFAP_GBM
AGATCCATCGACCATA-1	Normal
AGATCCATCGCGCTGA-1	GFAP_GBM
AGATCGTCAAAGACTA-1	Normal
AGATCGTCACGTAACT-1	Normal
AGATCGTGTATATGGA-1	VEGFA_GBM
AGATCGTGTGGTCTGC-1	Normal
AGATGAACAAATAGCA-1	Normal
AGATGAAGTGTATTGC-1	MEGF11_GBM
AGATGAAGTTTAGTCG-1	Normal
AGATGAATCACGTAGT-1	Normal
AGATGCTAGCCTTTCC-1	Normal
AGATGCTTCACTTATC-1	Normal
AGCATCAAGCGCCTCA-1	VEGFA_GBM
AGCATCAAGGTCATCT-1	MEGF11_GBM
AGCATCACACATACGT-1	Normal
AGCATCACAGCAGATG-1	Normal
AGCATCACATGGGTCC-1	VEGFA_GBM
AGCATCAGTGAACTAA-1	Normal
AGCATCAGTTCGGCGT-1	Normal
AGCATCAGTTGCAAGG-1	MEGF11_GBM
AGCATCATCGAACGGA-1	Normal
AGCCAATAGGCACGAT-1	Normal
AGCCAATCAAGAAATC-1	Normal
AGCCAATGTACGGATG-1	GFAP_GBM
AGCCAATTCATGCCCT-1	Normal
AGCCAATTCCAAGCCG-1	MEGF11_GBM
AGCCACGAGTGTACCT-1	Normal
AGCCACGCACATTGTG-1	Normal
AGCCACGGTATGACAA-1	MEGF11_GBM
AGCCACGGTCGCTTGG-1	MEGF11_GBM
AGCCACGTCTAATTCC-1	Normal
AGCCAGCAGCGTCAAG-1	MEGF11_GBM
AGCCAGCCATCATTTC-1	Normal
AGCCAGCGTACCCGCA-1	Normal
AGCCAGCGTGGGCTTC-1	GFAP_GBM
AGCCAGCTCGACACCG-1	GFAP_GBM
AGCGATTAGTCGCCCA-1	Normal
AGCGATTCAAATTAGG-1	Normal
AGCGATTCATCTTCGC-1	Normal
AGCGATTGTGCTAGCC-1	Normal
AGCGATTTCCATTGCC-1	VEGFA_GBM
AGCGCCACACCCTTGT-1	Normal
AGCGCCAGTTAGTCGT-1	VEGFA_GBM
AGCGCCATCCGAGATT-1	VEGFA_GBM
AGCGCTGCAGAACTCT-1	Normal
AGCGCTGGTCGGTAAG-1	MEGF11_GBM
AGCGCTGGTGACTCTA-1	MEGF11_GBM
AGCGCTGGTGTGTGGA-1	Normal
AGCGCTGTCGGTAAGG-1	MEGF11_GBM
AGCGTATAGCCTTTGA-1	Normal
AGCGTATAGGTTAAAC-1	Normal
AGCGTATCAGGCGAAT-1	MEGF11_GBM
AGCGTATCATGATGCT-1	Normal
AGCGTATGTACCTATG-1	Normal
AGCGTATGTCGACGCT-1	Normal
AGCGTATGTTATAGAG-1	Normal
AGCGTATTCCATTTAC-1	Normal
AGCGTATTCGCAACAT-1	Normal
AGCGTATTCGCAATTG-1	Normal
AGCGTCGAGATAACAC-1	Normal
AGCGTCGGTTGAATCC-1	GFAP_GBM
AGCTACACAGACACCC-1	MEGF11_GBM
AGCTACAGTGGTCTGC-1	Normal
AGCTACATCACTAGCA-1	GFAP_GBM
AGCTACATCCTACCGT-1	MEGF11_GBM
AGCTACATCGAGTGAG-1	Normal
AGCTACATCTGCCTCA-1	VEGFA_GBM
AGCTCAATCGTTGTGA-1	GFAP_GBM
AGCTTCCAGGTAATCA-1	VEGFA_GBM
AGCTTCCGTCATCCCT-1	MEGF11_GBM
AGCTTCCTCATTTACC-1	Normal
AGGAAATAGTCACTAC-1	Normal
AGGAAATGTATCGATC-1	Normal
AGGAAATGTCACTAGT-1	VEGFA_GBM
AGGAAATGTCCTTGTC-1	GFAP_GBM
AGGAAATGTCGCATCG-1	MEGF11_GBM
AGGAATAAGCACCTGC-1	Normal
AGGAATAAGCCTGTCG-1	Normal
AGGAATAAGGCGCTCT-1	Normal
AGGAATACACCGTACG-1	MEGF11_GBM
AGGAATACAGGTGACA-1	MEGF11_GBM
AGGAATACAGGTGGAT-1	Normal
AGGAATAGTCCTGTTC-1	Normal
AGGAATAGTGCGGATA-1	VEGFA_GBM
AGGACGAAGGATGCGT-1	GFAP_GBM
AGGACGAAGGTCGACA-1	Normal
AGGACGAGTCTCAGGC-1	Normal
AGGACTTAGGCACCAA-1	Normal
AGGACTTTCATACAGC-1	GFAP_GBM
AGGAGGTAGTAGGTTA-1	Normal
AGGAGGTCACTGGCCA-1	Normal
AGGAGGTGTGGTCTAT-1	GFAP_GBM
AGGAGGTTCTACACTT-1	MEGF11_GBM
AGGAGGTTCTGAGCAT-1	Normal
AGGATAACAACGGGTA-1	Normal
AGGATAAGTGCAATGG-1	Normal
AGGATCTGTCTTACAG-1	VEGFA_GBM
AGGATCTGTGAGACGT-1	MEGF11_GBM
AGGATCTGTGATAGTA-1	Normal
AGGCATTAGGGATCGT-1	GFAP_GBM
AGGCATTAGTTCATGC-1	Normal
AGGCATTCACACAGAG-1	GFAP_GBM
AGGCATTCACATGGTT-1	Normal
AGGCATTGTAGAGCTG-1	Normal
AGGCATTGTTGCTCGG-1	Normal
AGGCCACGTATGTCTG-1	Normal
AGGCCACGTCGAGCTC-1	MEGF11_GBM
AGGCCACTCTTCCACG-1	Normal
AGGCTGCAGCATCTTG-1	Normal
AGGCTGCCACTACCCT-1	Normal
AGGCTGCGTACCGCGT-1	VEGFA_GBM
AGGCTGCGTCCAATCA-1	MEGF11_GBM
AGGCTGCTCACTGTCC-1	Normal
AGGGAGTCATTGCTGA-1	GFAP_GBM
AGGGAGTGTACAGAAT-1	GFAP_GBM
AGGGAGTGTATGCGGA-1	GFAP_GBM
AGGGAGTGTCGAGATG-1	MEGF11_GBM
AGGGCCTAGCAGGCAT-1	Normal
AGGGCCTAGTAGGAAG-1	Normal
AGGGCCTCACATATCG-1	Normal
AGGGCCTCAGGGTTGA-1	GFAP_GBM
AGGGCCTGTACGTAGG-1	Normal
AGGGCCTGTCAAGCCC-1	Normal
AGGGCCTGTCACCTTC-1	GFAP_GBM
AGGGCCTGTCATCTAG-1	Normal
AGGGCCTGTCTATGAC-1	Normal
AGGGCCTTCACAGTGT-1	Normal
AGGGCCTTCCATCCGT-1	MEGF11_GBM
AGGGCCTTCGAGAACG-1	Normal
AGGGCTCAGAGATGCC-1	MEGF11_GBM
AGGGCTCGTTACGATC-1	Normal
AGGGTCCAGCTGGTGA-1	VEGFA_GBM
AGGGTCCAGGCTAAAT-1	MEGF11_GBM
AGGGTCCGTAGACAGC-1	MEGF11_GBM
AGGGTCCGTTACCGTA-1	VEGFA_GBM
AGGGTCCGTTCGGTAT-1	Normal
AGGGTCCTCGTCACCT-1	GFAP_GBM
AGGGTGACAAAGAGTT-1	Normal
AGGGTGACAAAGCGTG-1	MEGF11_GBM
AGGGTGACAACTGGTT-1	Normal
AGGGTGAGTAGCCCTG-1	Normal
AGGGTGAGTGTCCATA-1	GFAP_GBM
AGGGTGATCAAGAGTA-1	Normal
AGGGTGATCAGCTTCC-1	Normal
AGGGTTTCAGATTCGT-1	MEGF11_GBM
AGGGTTTCATGGCACC-1	Normal
AGGGTTTGTCCGGACT-1	Normal
AGGGTTTTCAAGAAAC-1	VEGFA_GBM
AGGGTTTTCTGTAAGC-1	VEGFA_GBM
AGGTAGGCACCCTCTA-1	MEGF11_GBM
AGGTAGGCAGCATGCC-1	Normal
AGGTAGGGTACCGTGC-1	Normal
AGGTAGGTCACTGTCC-1	Normal
AGGTAGGTCCGGACGT-1	VEGFA_GBM
AGGTAGGTCGGTCTGG-1	Normal
AGGTCATAGCTCGACC-1	Normal
AGGTCATAGGATCATA-1	Normal
AGGTCATCAACAGAGC-1	Normal
AGGTCATGTTGCACGC-1	Normal
AGGTCATTCGAGAATA-1	MEGF11_GBM
AGGTCATTCTCAATCT-1	GFAP_GBM
AGGTCATTCTCGCTTG-1	Normal
AGGTCTAAGAAACCAT-1	Normal
AGGTCTACAACTGCCG-1	Normal
AGGTCTACACGTTGGC-1	Normal
AGGTCTACAGACAAGC-1	GFAP_GBM
AGGTGTTAGCGTGTCC-1	GFAP_GBM
AGGTGTTCAAGAAATC-1	Normal
AGGTGTTCAGACCAAG-1	GFAP_GBM
AGGTGTTCATCTAACG-1	Normal
AGGTGTTGTACCTATG-1	MEGF11_GBM
AGGTTACAGTGGAAGA-1	GFAP_GBM
AGGTTACCAACTGCCG-1	Normal
AGGTTACTCAACGCTA-1	Normal
AGGTTACTCTCTATAC-1	Normal
AGGTTGTCATCCGTGG-1	Normal
AGGTTGTGTACCACGC-1	Normal
AGGTTGTGTTCGAGCC-1	Normal
AGTAACCAGGAAGAAC-1	MEGF11_GBM
AGTAACCGTAGACAAT-1	Normal
AGTAACCGTCGGTAAG-1	VEGFA_GBM
AGTAACCGTGCATGAG-1	MEGF11_GBM
AGTAACCGTTACCTGA-1	GFAP_GBM
AGTAACCTCTTACGTT-1	MEGF11_GBM
AGTACCAAGGTCATCT-1	Clone_2nd
AGTACCAAGTTGCTGT-1	Normal
AGTACCAGTAGAATAC-1	Normal
AGTACCAGTGGTCTAT-1	Normal
AGTACTGGTACGTTCA-1	Normal
AGTACTGGTCACTCAA-1	Clone_2nd
AGTACTGGTTGGACTT-1	Normal
AGTAGCTAGAAACCCG-1	MEGF11_GBM
AGTAGCTCAATGCAAA-1	Normal
AGTAGCTCACTGGCCA-1	Normal
AGTAGTCAGCCTGTGC-1	Normal
AGTAGTCCATGGCGCT-1	Normal
AGTAGTCGTATGCGGA-1	Normal
AGTAGTCTCAAATGAG-1	GFAP_GBM
AGTAGTCTCAATGTCG-1	MEGF11_GBM
AGTAGTCTCGAGTCTA-1	GFAP_GBM
AGTCACAGTGTTTGCA-1	MEGF11_GBM
AGTCACAGTTACACTG-1	Normal
AGTCACATCGAACGGA-1	MEGF11_GBM
AGTCACATCTGTAACG-1	Normal
AGTCACATCTTCACGC-1	Normal
AGTCATGAGAAATTGC-1	GFAP_GBM
AGTCATGCACACCGCA-1	Normal
AGTCATGCACCAGCTG-1	MEGF11_GBM
AGTCATGCAGCATACT-1	VEGFA_GBM
AGTCTCCAGAAGAGCA-1	Normal
AGTCTCCCAGCGAGTA-1	Normal
AGTCTCCTCCAGCACG-1	Normal
AGTGACTCAGCTGGTC-1	Clone_2nd
AGTGACTGTTAATGAG-1	Normal
AGTGATCAGCCATATC-1	Normal
AGTGATCCATGGTGGA-1	Normal
AGTGATCTCTACGCAA-1	Normal
AGTGCCGAGAATCCCT-1	Normal
AGTGCCGAGGTCACCC-1	Normal
AGTGCCGCATGGCCCA-1	VEGFA_GBM
AGTGCCGTCGTTAGAC-1	MEGF11_GBM
AGTGTTGCAGAGTGTG-1	MEGF11_GBM
AGTTAGCAGACTCATC-1	MEGF11_GBM
AGTTAGCAGGCTTTCA-1	Normal
AGTTAGCCAAGGCTTT-1	VEGFA_GBM
AGTTAGCTCATTACGG-1	MEGF11_GBM
AGTTAGCTCTCATTAC-1	GFAP_GBM
AGTTAGCTCTTACGTT-1	MEGF11_GBM
AGTTCCCAGATCGCCC-1	Normal
AGTTCCCAGCGATCGA-1	GFAP_GBM
AGTTCCCAGTCACGCC-1	Normal
AGTTCCCCAATTGCTG-1	GFAP_GBM
AGTTCCCCAGAGAAAG-1	Normal
AGTTCCCGTCGGCCTA-1	Normal
AGTTCCCGTGCAAGAC-1	Normal
AGTTCCCGTGTTCCTC-1	VEGFA_GBM
AGTTCCCGTTCAGGTT-1	Normal
AGTTCCCTCATCGGGC-1	Normal
AGTTCCCTCATTATCC-1	Normal
AGTTCGAAGGATGAGA-1	Normal
AGTTCGACATTACGGT-1	GFAP_GBM
AGTTCGAGTAGAGTTA-1	Normal
AGTTCGATCGTCTAAG-1	Normal
AGTTCGATCTTGATTC-1	Normal
ATACCGAAGTCCCGAC-1	Normal
ATACCGACAATTCTTC-1	VEGFA_GBM
ATACCGACATGATCTG-1	VEGFA_GBM
ATACCGAGTGCGGTAA-1	MEGF11_GBM
ATACCTTAGTAAACTG-1	VEGFA_GBM
ATACCTTCACGGATCC-1	Normal
ATACCTTCAGTCAGAG-1	MEGF11_GBM
ATACCTTGTTCTTCAT-1	Normal
ATACTTCCAATAACCC-1	Normal
ATACTTCTCGCAATTG-1	Normal
ATAGACCGTACTGACT-1	Normal
ATAGACCTCATTTACC-1	MEGF11_GBM
ATAGACCTCCATCCGT-1	Normal
ATAGACCTCTTCTGGC-1	GFAP_GBM
ATAGAGAAGGGAACAA-1	Normal
ATAGAGAAGGGATCGT-1	VEGFA_GBM
ATAGAGATCTTACGGA-1	Normal
ATAGGCTCAACTCATG-1	Normal
ATAGGCTGTATCGTGT-1	GFAP_GBM
ATAGGCTTCGCAAGAG-1	Normal
ATATCCTAGTATAGAC-1	Normal
ATATCCTAGTGTAGTA-1	Normal
ATATCCTCACTTTATC-1	MEGF11_GBM
ATATCCTCAGCAATTC-1	MEGF11_GBM
ATATCCTGTCGAACGA-1	MEGF11_GBM
ATATCCTGTTGCAACT-1	Normal
ATATCCTTCTCCTGCA-1	GFAP_GBM
ATCACAGAGACCGCCT-1	Normal
ATCACAGAGCTCCGAC-1	Normal
ATCACAGCAGCGTGAA-1	MEGF11_GBM
ATCACAGCATGACGTT-1	VEGFA_GBM
ATCACAGTCAGTCTTT-1	Normal
ATCACAGTCCCGTTGT-1	Normal
ATCACGAAGGGAGATA-1	Normal
ATCACGATCGCCTTGT-1	Normal
ATCACGATCTCACCCA-1	Normal
ATCACTTAGACCGTTT-1	Normal
ATCACTTAGATGGTCG-1	Normal
ATCACTTGTGGCTCTG-1	VEGFA_GBM
ATCACTTTCTCATTTG-1	VEGFA_GBM
ATCACTTTCTTAGGAC-1	Normal
ATCAGGTAGGCAGGTT-1	MEGF11_GBM
ATCAGGTAGTGCTCGC-1	Normal
ATCAGGTCAACGATTC-1	VEGFA_GBM
ATCAGGTCACAAGTTC-1	Normal
ATCAGGTCATTCACAG-1	Normal
ATCAGGTGTTACACTG-1	Normal
ATCAGGTTCCGATTAG-1	Normal
ATCATTCCAAGAGTTA-1	MEGF11_GBM
ATCATTCCATGATGCT-1	Normal
ATCCACCAGCACTCGC-1	Normal
ATCCACCTCGCGTTTC-1	Normal
ATCCACCTCTTCCTAA-1	VEGFA_GBM
ATCCATTCAGTTCTAG-1	GFAP_GBM
ATCCATTGTATCGCTA-1	Normal
ATCCATTGTCTCTCTG-1	Normal
ATCCATTTCCCATTTA-1	Normal
ATCCATTTCCGCTAGG-1	Normal
ATCCATTTCGACGCTG-1	Normal
ATCCATTTCGTCCTTG-1	MEGF11_GBM
ATCCCTGAGACCCGCT-1	MEGF11_GBM
ATCCCTGAGCAAACAT-1	GFAP_GBM
ATCCCTGAGGCCCGTT-1	Normal
ATCCCTGGTGACGTCC-1	Normal
ATCCCTGTCAGTCATG-1	Normal
ATCCCTGTCGTAACAC-1	Normal
ATCCGTCAGAGTGACC-1	VEGFA_GBM
ATCCGTCAGGCGAAGG-1	VEGFA_GBM
ATCCGTCAGTAGGAAG-1	Normal
ATCCGTCCAAGAGATT-1	MEGF11_GBM
ATCCGTCCAATGAAAC-1	VEGFA_GBM
ATCCGTCCAGCATGCC-1	MEGF11_GBM
ATCCGTCCAGTTAGGG-1	Normal
ATCCGTCGTCGCAGTC-1	Normal
ATCCGTCTCACACGAT-1	MEGF11_GBM
ATCCGTCTCGTGCACG-1	MEGF11_GBM
ATCCTATAGTCATAGA-1	Normal
ATCCTATCAAGTGCTT-1	MEGF11_GBM
ATCCTATCAGTTTGGT-1	Normal
ATCCTATCATGGAACG-1	Normal
ATCCTATGTATGCGTT-1	Normal
ATCCTATTCATCACAG-1	GFAP_GBM
ATCGATGAGTCCCAGC-1	GFAP_GBM
ATCGATGAGTCCGCCA-1	Normal
ATCGATGCATCATCTT-1	GFAP_GBM
ATCGATGTCGCGGACT-1	MEGF11_GBM
ATCGCCTGTGAGTCAG-1	Normal
ATCGCCTTCTCTCTTC-1	Normal
ATCGGATAGTCGCGAA-1	MEGF11_GBM
ATCGGATAGTCTTGGT-1	Normal
ATCGGATCAGTTAGGG-1	Normal
ATCGGATGTGCACGCT-1	GFAP_GBM
ATCGGATGTTGGGCCT-1	Normal
ATCGGATTCGATACGT-1	VEGFA_GBM
ATCGGATTCGCTATTT-1	GFAP_GBM
ATCGGCGAGCCTGACC-1	VEGFA_GBM
ATCGGCGAGTCATAGA-1	MEGF11_GBM
ATCGGCGCAAGTGCAG-1	Normal
ATCGGCGGTAGGTACG-1	Clone_2nd
ATCGGCGGTATTTCTC-1	Normal
ATCGGCGGTTTAGACC-1	MEGF11_GBM
ATCGGCGTCACCCTCA-1	MEGF11_GBM
ATCGGCGTCCTTCAGC-1	MEGF11_GBM
ATCGGCGTCGATTCCC-1	GFAP_GBM
ATCGGCGTCGTTGCCT-1	Normal
ATCGTAGCACGCTATA-1	Normal
ATCGTAGCAGTCTACA-1	GFAP_GBM
ATCGTAGTCATTCTTG-1	Normal
ATCGTCCAGGAAAGAC-1	MEGF11_GBM
ATCGTCCAGTCATCCA-1	VEGFA_GBM
ATCGTCCTCATACAGC-1	Normal
ATCGTCCTCATAGCAC-1	Normal
ATCGTCCTCGCTTAAG-1	Normal
ATCGTCCTCTTGTTAC-1	Normal
ATCGTGACAAACTGCT-1	Normal
ATCGTGACATGCGTGC-1	GFAP_GBM
ATCGTGAGTCCACAGC-1	Normal
ATCGTGATCGCAGTGC-1	Normal
ATCGTGATCTGCCTGT-1	Normal
ATCTCTACAACCGCCA-1	Normal
ATCTTCATCCAACTGA-1	GFAP_GBM
ATCTTCATCGCTAATG-1	Normal
ATCTTCATCTCGCTTG-1	VEGFA_GBM
ATCTTCATCTTTGGAG-1	MEGF11_GBM
ATGAAAGCAGGCGTTC-1	GFAP_GBM
ATGAAAGCAGGGTCTC-1	Normal
ATGAAAGTCCGTGACG-1	MEGF11_GBM
ATGACCACAAACCATC-1	Normal
ATGACCACAAGAAATC-1	Normal
ATGACCACAAGTAGTA-1	Normal
ATGAGGGCACGCGCTA-1	VEGFA_GBM
ATGAGGGGTCGGCACT-1	Normal
ATGAGGGGTGTCCTAA-1	VEGFA_GBM
ATGAGGGTCATTCGGA-1	Normal
ATGAGTCAGAAGTCTA-1	Normal
ATGAGTCGTCATCTAG-1	MEGF11_GBM
ATGATCGAGAGAGAAC-1	VEGFA_GBM
ATGATCGAGCGATGGT-1	VEGFA_GBM
ATGATCGAGGTCCGAA-1	GFAP_GBM
ATGATCGAGTCCGCCA-1	GFAP_GBM
ATGATCGCAGCCTTCT-1	MEGF11_GBM
ATGATCGCATTGCTTT-1	Normal
ATGCATGCACTACTTT-1	Normal
ATGCATGCAGCGCGTT-1	Normal
ATGCATGTCATAGAGA-1	Normal
ATGCATGTCATTGCTT-1	Normal
ATGCCTCTCCACGTGG-1	Normal
ATGCCTCTCGCACGGT-1	Normal
ATGCGATCAGGCATTT-1	Normal
ATGCGATCAGGCCCTA-1	Normal
ATGCGATCAGTCGCTG-1	Normal
ATGGAGGGTGAGATAT-1	Normal
ATGGAGGTCCTCTCGA-1	GFAP_GBM
ATGGAGGTCGAAGAAT-1	GFAP_GBM
ATGGATCGTCCCGCAA-1	VEGFA_GBM
ATGGATCGTCTTTCTA-1	Normal
ATGGGAGAGCACGTCC-1	Normal
ATGGGAGCACGGAAGT-1	Normal
ATGGGAGTCTTGGGCG-1	VEGFA_GBM
ATGGGTTAGACCATGG-1	GFAP_GBM
ATGGGTTAGTCACTAC-1	Normal
ATGGGTTCAAATCAAG-1	Normal
ATGGGTTCAGCTGTTA-1	Normal
ATGGGTTGTCTTACTT-1	Normal
ATGGGTTTCATGTCAG-1	Normal
ATGGGTTTCGAAGGAC-1	Normal
ATGGGTTTCGCTGTCT-1	GFAP_GBM
ATGGTTGAGAGATCGC-1	Normal
ATGGTTGCAAGTAGTA-1	Normal
ATGGTTGCAAGTGCAG-1	Normal
ATGGTTGTCTGACAGT-1	Normal
ATGTCCCAGAGCAGTC-1	Normal
ATGTCCCAGGTATCTC-1	Normal
ATGTCCCGTACGATGG-1	Normal
ATGTCCCGTAGTCTTG-1	MEGF11_GBM
ATGTCCCGTCCGATCG-1	MEGF11_GBM
ATGTCTTAGACTTCCA-1	MEGF11_GBM
ATGTCTTAGCTTCTAG-1	Normal
ATGTCTTAGGGTTGCA-1	Normal
ATGTCTTGTACATTGC-1	MEGF11_GBM
ATGTCTTGTCATACCA-1	Normal
ATGTCTTGTGGCCCAT-1	MEGF11_GBM
ATGTCTTTCCATTGGA-1	Normal
ATTACCTAGAGATCGC-1	Normal
ATTACCTCAGCTTTGA-1	Normal
ATTACCTCATGACTCA-1	VEGFA_GBM
ATTACCTGTCCTACGG-1	VEGFA_GBM
ATTACCTTCGTGTGGC-1	Normal
ATTACCTTCTACCCAC-1	GFAP_GBM
ATTACTCAGTATTCCG-1	Normal
ATTACTCCATCCGAGC-1	Normal
ATTACTCTCGGTGTAT-1	MEGF11_GBM
ATTACTCTCTTTGCTA-1	Normal
ATTATCCCACTACCCT-1	Normal
ATTCACTAGAAGCCTG-1	Normal
ATTCACTCACGACCTG-1	MEGF11_GBM
ATTCACTGTAGAATAC-1	Normal
ATTCACTGTCACTCTC-1	MEGF11_GBM
ATTCACTGTGCACAAG-1	Normal
ATTCACTTCACAGAGG-1	Normal
ATTCAGGAGGCCGCTT-1	GFAP_GBM
ATTCAGGAGGGTCACA-1	MEGF11_GBM
ATTCAGGGTAGTCCTA-1	GFAP_GBM
ATTCAGGGTCGGCACT-1	Normal
ATTCAGGGTCTGCAAT-1	VEGFA_GBM
ATTCATCCAACGCATT-1	MEGF11_GBM
ATTCATCCAATGGCAG-1	GFAP_GBM
ATTCATCCAGCGGATA-1	Normal
ATTCATCCATGTCAGT-1	VEGFA_GBM
ATTCATCGTATGACAA-1	MEGF11_GBM
ATTCATCGTCTCACGG-1	Normal
ATTCATCTCCATAGAC-1	Normal
ATTCATCTCTGGGCAC-1	Normal
ATTCCATAGTCTAGCT-1	Normal
ATTCCATGTAATGCGG-1	Normal
ATTCCATTCGGTGAAG-1	Normal
ATTCCCGAGTTGAATG-1	GFAP_GBM
ATTCCCGCACACCGCA-1	Normal
ATTCCCGGTATGGTAA-1	VEGFA_GBM
ATTCCCGGTCCTCCAT-1	Normal
ATTCCCGGTGGTCTCG-1	VEGFA_GBM
ATTCCCGGTTCGCGTG-1	Normal
ATTCCCGGTTTACTGG-1	Normal
ATTCCCGTCGCCAACG-1	GFAP_GBM
ATTCCTAAGAGTCGAC-1	GFAP_GBM
ATTCCTACACCCGTAG-1	MEGF11_GBM
ATTCCTAGTCCTGTTC-1	MEGF11_GBM
ATTCCTAGTGGCCTCA-1	Normal
ATTCCTATCCTTACCG-1	Normal
ATTCGTTTCCATTTGT-1	MEGF11_GBM
ATTCTACCAAGAAACT-1	GFAP_GBM
ATTCTTGAGGAAAGTG-1	GFAP_GBM
ATTCTTGCAAATAGCA-1	Normal
ATTCTTGGTACGTACT-1	GFAP_GBM
ATTCTTGGTATGCTAC-1	Normal
ATTCTTGTCAAAGCCT-1	Normal
ATTGGGTAGACAGCTG-1	Normal
ATTGGGTAGCCGAACA-1	GFAP_GBM
ATTGGGTCAACAACAA-1	Normal
ATTGGGTCAGCGACAA-1	Normal
ATTGGGTCAGGAGGTT-1	MEGF11_GBM
ATTGGGTGTATGATCC-1	GFAP_GBM
ATTGGGTGTCCTCAGG-1	Normal
ATTGGGTGTGGAACAC-1	Normal
ATTGGGTGTGTCATCA-1	Normal
ATTGGGTGTTAGCGGA-1	Normal
ATTGGGTTCGCCGAGT-1	Normal
ATTGTTCAGACGCTCC-1	Normal
ATTGTTCAGATGGGCT-1	Normal
ATTGTTCTCCTACCGT-1	Normal
ATTTACCGTAAGCTCT-1	GFAP_GBM
ATTTACCTCACTCGAA-1	Normal
ATTTACCTCCGTCACT-1	VEGFA_GBM
ATTTCACAGACACACG-1	Normal
ATTTCACCAGCAGTGA-1	GFAP_GBM
ATTTCACCATACAGCT-1	Normal
ATTTCTGAGCCGATTT-1	VEGFA_GBM
ATTTCTGCACACCAGC-1	Normal
ATTTCTGGTACCGCGT-1	Normal
ATTTCTGGTGGATCGA-1	Normal
CAAAGAACAATCGCCG-1	Normal
CAAAGAAGTAGAATGT-1	MEGF11_GBM
CAAAGAAGTGTGCTTA-1	Normal
CAACAACAGACGCATG-1	Normal
CAACAACCAGACAAAT-1	Normal
CAACAACCATGGCCAC-1	Normal
CAACAACGTGCCGGTT-1	MEGF11_GBM
CAACAACTCAAGCCGC-1	VEGFA_GBM
CAACAGTGTATGACAA-1	MEGF11_GBM
CAACCAAAGTCTCTGA-1	GFAP_GBM
CAACCAAAGTGTACCT-1	Normal
CAACCAACAAGAAATC-1	Normal
CAACCAAGTAGACTGG-1	Normal
CAACCAATCCGTATAG-1	Normal
CAACCAATCGCAGAGA-1	MEGF11_GBM
CAACCTCAGGAGCAAA-1	VEGFA_GBM
CAACCTCGTAGTGTGG-1	Normal
CAACCTCTCCGACGGT-1	MEGF11_GBM
CAACGATAGTTGTAAG-1	Normal
CAACGATTCTATTGTC-1	GFAP_GBM
CAACGGCAGAGGTATT-1	Normal
CAACGGCAGGTCCTGC-1	GFAP_GBM
CAACGGCTCTCACTCG-1	GFAP_GBM
CAACGGCTCTTTCTAG-1	GFAP_GBM
CAAGACTCACACACTA-1	Normal
CAAGACTCAGGAATAT-1	GFAP_GBM
CAAGACTGTCCCAAAT-1	Normal
CAAGACTTCCAGCACG-1	Normal
CAAGAGGAGCTAGCCC-1	MEGF11_GBM
CAAGAGGAGGCAGGGA-1	Normal
CAAGAGGCAGAAGTGC-1	Normal
CAAGAGGCAGAGAGGG-1	Normal
CAAGCTACAGTTGTTG-1	Normal
CAAGCTAGTCCACTTC-1	Normal
CAAGCTAGTCCCGGTA-1	Normal
CAAGCTATCAGGGATG-1	Normal
CAAGGGACATCTGTTT-1	Normal
CAAGGGATCAAATGAG-1	Normal
CAAGGGATCCGTATAG-1	Normal
CAAGGGATCGGCTCTT-1	Normal
CAATACGAGCACTCCG-1	Normal
CAATACGAGGTTGCCC-1	Normal
CAATACGCAGTAGAGC-1	Normal
CAATACGCATGAGAAT-1	MEGF11_GBM
CAATACGGTGTAGGAC-1	GFAP_GBM
CAATACGGTTCTCACC-1	Normal
CAATCGAAGCGGACAT-1	Normal
CAATCGAAGTGTTCCA-1	VEGFA_GBM
CAATCGAGTAGACAAT-1	MEGF11_GBM
CAATCGAGTCGGTGAA-1	Normal
CAATCGAGTGCGGCTT-1	MEGF11_GBM
CAATCGATCAGCCTCT-1	GFAP_GBM
CAATCGATCAGTGTGT-1	Normal
CAATGACGTAAGGAGA-1	Normal
CAATGACGTACGATCT-1	MEGF11_GBM
CAATGACGTCGTTGCG-1	GFAP_GBM
CAATGACTCGAACGCC-1	Normal
CAATGACTCGATACAC-1	Normal
CAATGACTCGTAGTGT-1	Normal
CAATTTCGTAGATTGA-1	Normal
CAATTTCGTAGTTCCA-1	Normal
CAATTTCGTTGCGGCT-1	MEGF11_GBM
CAATTTCTCAAGAGGC-1	MEGF11_GBM
CAATTTCTCTAACACG-1	Normal
CACAACACAAGGTCGA-1	Normal
CACAACACAGATCACT-1	Normal
CACAACATCAAACCCA-1	MEGF11_GBM
CACAACATCAGCGTCG-1	Normal
CACACAACATCTTAGG-1	Normal
CACACAAGTATCTTCT-1	Normal
CACAGATCAAGCGATG-1	Normal
CACAGATCAGTGACCC-1	Normal
CACAGATCATTGACCA-1	Normal
CACAGATGTGCAGGAT-1	VEGFA_GBM
CACAGATTCCGGCTTT-1	Normal
CACAGGCAGCGATGAC-1	Normal
CACAGGCAGTAAACAC-1	Normal
CACAGGCCAACACGTT-1	Normal
CACAGGCCAGCGCTTG-1	Normal
CACAGGCGTAGTCACT-1	VEGFA_GBM
CACAGGCGTGAGTAAT-1	MEGF11_GBM
CACAGGCGTGCCCTTT-1	Normal
CACAGGCTCATGAAAG-1	Normal
CACATGAAGTCTGGAG-1	Normal
CACATGACAGCTCATA-1	VEGFA_GBM
CACATGAGTCCTGTCT-1	Normal
CACATGAGTTTCGGCG-1	MEGF11_GBM
CACATGATCCACTGGG-1	Normal
CACATGATCGCAGAGA-1	Normal
CACCAAAAGTGAATAC-1	Normal
CACCAAACAAATAAGC-1	GFAP_GBM
CACCAAACACTAGAGG-1	MEGF11_GBM
CACCAAACATCATTTC-1	Normal
CACCAAATCAGCAGAG-1	Normal
CACCAAATCTAAGCCA-1	Normal
CACCAAATCTTCTCAA-1	MEGF11_GBM
CACCGTTAGCTGACCC-1	Normal
CACCGTTCACATACTG-1	VEGFA_GBM
CACCGTTCACATTACG-1	Normal
CACCGTTCAGGATTCT-1	Normal
CACCGTTGTAAGATCA-1	Normal
CACCGTTGTGATTCAC-1	MEGF11_GBM
CACGAATAGCGTGCCT-1	MEGF11_GBM
CACGAATAGTTCCGGC-1	Normal
CACGAATGTCCCAAAT-1	MEGF11_GBM
CACGGGTAGGGCAACT-1	Normal
CACGGGTAGGTCCCTG-1	Normal
CACGGGTCAAGACCTT-1	MEGF11_GBM
CACGGGTCACTCCGGA-1	Normal
CACGGGTCATGTTACG-1	MEGF11_GBM
CACGGGTCATTGACCA-1	Normal
CACGGGTGTCAAAGCG-1	Normal
CACGGGTGTCTCACAA-1	Normal
CACGGGTGTGTCCAAT-1	Normal
CACGTGGAGCGTTAGG-1	Normal
CACGTGGCAAATGGAT-1	Normal
CACGTGGCAGATACCT-1	MEGF11_GBM
CACGTGGGTAGGAGGG-1	Clone_2nd
CACGTGGTCAAAGACA-1	Normal
CACGTTCCAAGAGGCT-1	Normal
CACGTTCCAATTCTTC-1	Normal
CACGTTCCACTAACGT-1	MEGF11_GBM
CACGTTCGTACAAGTA-1	MEGF11_GBM
CACGTTCGTCTCAAGT-1	Normal
CACTAAGAGACTGTTC-1	VEGFA_GBM
CACTAAGAGTCACAGG-1	GFAP_GBM
CACTAAGCAGTCGAGA-1	Normal
CACTAAGTCGGCATAT-1	Normal
CACTGAAAGTAGGAAG-1	Clone_2nd
CACTGAAGTATGCAAA-1	Normal
CACTGAAGTCATAGTC-1	MEGF11_GBM
CACTGAAGTGATACCT-1	VEGFA_GBM
CACTGAAGTTCTCCAC-1	Normal
CACTGAATCACACCGG-1	GFAP_GBM
CACTGAATCCAGCTCT-1	MEGF11_GBM
CACTGGGCACACACGC-1	MEGF11_GBM
CACTGTCCAATCAGCT-1	MEGF11_GBM
CACTGTCTCGATGCTA-1	Normal
CACTGTCTCTTCCAGC-1	MEGF11_GBM
CACTTCGAGACCGTTT-1	Normal
CACTTCGAGACGCCCT-1	Normal
CACTTCGAGTTAGTAG-1	Normal
CACTTCGCAAGCACCC-1	MEGF11_GBM
CACTTCGCACATGGTT-1	GFAP_GBM
CACTTCGTCTCTGCCA-1	MEGF11_GBM
CAGAGCCCATCTAACG-1	Normal
CAGAGCCGTAACCCTA-1	Normal
CAGAGCCGTCCAGCCA-1	Normal
CAGAGCCGTCTGCGCA-1	Normal
CAGATCAAGCACACCC-1	Normal
CAGATCAAGCATGGGT-1	MEGF11_GBM
CAGATCATCCGAAATC-1	Normal
CAGATCATCTAAGAAG-1	Normal
CAGATTGAGGCTCTAT-1	MEGF11_GBM
CAGATTGAGTGATAGT-1	MEGF11_GBM
CAGATTGGTCCTACAA-1	Normal
CAGATTGGTTCAGGTT-1	Clone_2nd
CAGATTGTCACCTTAT-1	GFAP_GBM
CAGATTGTCGTGGTAT-1	Normal
CAGCAATAGGCCACTC-1	Normal
CAGCAATCAACCCTCT-1	Normal
CAGCAATCACAGACGA-1	Normal
CAGCAATTCAGCCTCT-1	GFAP_GBM
CAGCAATTCGACGTCG-1	MEGF11_GBM
CAGCACGCATAGGAGC-1	Normal
CAGCACGGTTGTGTTG-1	MEGF11_GBM
CAGCAGCAGACTACGG-1	MEGF11_GBM
CAGCAGCCAAGACGGT-1	GFAP_GBM
CAGCAGCCAGTTACCA-1	MEGF11_GBM
CAGCAGCCATCGGTTA-1	Normal
CAGCAGCTCCGTTGAA-1	MEGF11_GBM
CAGCAGCTCTCATTAC-1	Normal
CAGCCAGAGTATAGAC-1	Normal
CAGCCAGGTAATCAAG-1	MEGF11_GBM
CAGCGTGAGTGAACAT-1	GFAP_GBM
CAGCGTGGTTCTTGTT-1	GFAP_GBM
CAGCGTGTCAGACAAA-1	VEGFA_GBM
CAGCGTGTCCATCTGC-1	MEGF11_GBM
CAGGCCAAGCAACTTC-1	Normal
CAGGCCACACACACGC-1	Normal
CAGGGCTAGCCAGTAG-1	Normal
CAGGGCTCAACCTATG-1	Normal
CAGGGCTCATGTAACC-1	Normal
CAGGTATAGGTTACCT-1	Normal
CAGGTATGTATACAGA-1	Normal
CAGGTATGTCGAATTC-1	GFAP_GBM
CAGGTATGTTGGGCCT-1	Normal
CAGTGCGAGGTTCCAT-1	MEGF11_GBM
CAGTGCGCAAATGCTC-1	Normal
CAGTGCGCAGCCCAGT-1	VEGFA_GBM
CAGTGCGGTAGTAAGT-1	MEGF11_GBM
CAGTGCGGTCTTGCTC-1	Normal
CAGTGCGTCTAGGCAT-1	Normal
CAGTTAGCAACGGCCT-1	GFAP_GBM
CAGTTAGCAAGACTGG-1	Normal
CAGTTAGGTAGCGAGT-1	Normal
CAGTTAGTCTCCAAGA-1	GFAP_GBM
CAGTTCCGTTCATCTT-1	Normal
CATAAGCAGAATCCCT-1	Normal
CATAAGCCAAGTATCC-1	MEGF11_GBM
CATAAGCGTATACCTG-1	Normal
CATAAGCTCGCAACAT-1	GFAP_GBM
CATAAGCTCTATTGTC-1	GFAP_GBM
CATACAGCAACGGCCT-1	Normal
CATACAGCAGGGTCTC-1	Normal
CATACAGTCGATGCAT-1	VEGFA_GBM
CATACAGTCGCCGTGA-1	Normal
CATACCCAGCTGCCAC-1	Normal
CATACCCAGGATTACA-1	MEGF11_GBM
CATACCCGTAGTTAGA-1	MEGF11_GBM
CATACCCTCTCCGCAT-1	Normal
CATACTTAGTATGAAC-1	Normal
CATACTTCAACTCATG-1	Normal
CATACTTGTATCCTTT-1	Normal
CATACTTGTCCTCATC-1	Normal
CATACTTGTTGCTCAA-1	Normal
CATCAAGCAACCCTCT-1	VEGFA_GBM
CATCAAGCAGCCGTTG-1	VEGFA_GBM
CATCAAGTCGCTGACG-1	Normal
CATCAAGTCTCGCTCA-1	Normal
CATCCACAGAGCTGAC-1	MEGF11_GBM
CATCCACAGCTACTAC-1	GFAP_GBM
CATCCACCACCAATTG-1	Normal
CATCCACCACGGGCTT-1	Normal
CATCCACCAGGATGAC-1	Normal
CATCCACGTGCATCTA-1	Normal
CATCCACTCGTCACCT-1	Normal
CATCCCAAGGGTTAAT-1	Normal
CATCCCAAGTGGTTAA-1	Normal
CATCCCACAATCTCTT-1	MEGF11_GBM
CATCCCACACTTCATT-1	Normal
CATCCCAGTCTGTGAT-1	Normal
CATCCCAGTTAAACAG-1	Clone_2nd
CATCCGTAGAGCGACT-1	VEGFA_GBM
CATCCGTAGCGCCTAC-1	VEGFA_GBM
CATCCGTAGCGCGTTC-1	Normal
CATCCGTAGTGCGACA-1	MEGF11_GBM
CATCCGTCAATACGAA-1	Normal
CATCCGTCACGCTGTG-1	MEGF11_GBM
CATCCGTGTGCGTCGT-1	Normal
CATCCGTTCAGGGATG-1	Normal
CATCCGTTCAGTCTTT-1	Normal
CATCGCTAGGAGACCT-1	Normal
CATCGCTAGTCACGCC-1	GFAP_GBM
CATCGCTCAAAGTATG-1	GFAP_GBM
CATCGCTCACTGCGAC-1	MEGF11_GBM
CATCGCTCAGGCCTGT-1	GFAP_GBM
CATCGCTGTGAACTAA-1	Normal
CATCGCTGTGATACCT-1	Normal
CATCGCTTCACCTGGG-1	GFAP_GBM
CATCGGGAGGGTCTTT-1	Normal
CATCGGGGTACTGCCG-1	Normal
CATCGGGTCATCGCAA-1	GFAP_GBM
CATCGTCAGAATCGAT-1	Normal
CATCGTCAGGTAGATT-1	Normal
CATCGTCAGTAGGCCA-1	Normal
CATCGTCCACCCAAGC-1	GFAP_GBM
CATGAGTCAATCGTCA-1	Normal
CATGAGTCATCCTGTC-1	Normal
CATGAGTGTGCTCCGA-1	Normal
CATGAGTGTGTCCATA-1	Normal
CATGCAAAGCAGATAT-1	MEGF11_GBM
CATGCAACAACTGCCG-1	Normal
CATGCAACAAGGCTTT-1	Normal
CATGCCTCAAGTGCTT-1	Normal
CATGCCTCACTAAACC-1	Normal
CATGCCTTCAGGACAG-1	Normal
CATGCGGAGGGAGTGG-1	Normal
CATGCGGCAGACACAG-1	GFAP_GBM
CATGCGGGTCAACCAT-1	Normal
CATGCGGGTGGCAACA-1	Normal
CATGCGGTCCACGTAA-1	Normal
CATGCTCCATACCGTA-1	Normal
CATGCTCGTGATTCTG-1	Normal
CATGCTCGTGGCTTGC-1	Normal
CATGCTCGTGGGTTGA-1	Normal
CATGCTCTCTCATGCC-1	VEGFA_GBM
CATGGATAGATAGGGA-1	Normal
CATGGATAGCCTATTG-1	Normal
CATGGATTCAGAGCAG-1	MEGF11_GBM
CATGGTAAGCAGCGAT-1	VEGFA_GBM
CATGGTACAAGACAAT-1	Normal
CATGGTATCGAAGCCC-1	Normal
CATTCATAGCGGACAT-1	Normal
CATTCATAGGGATCTG-1	GFAP_GBM
CATTCCGAGCGACTTT-1	Normal
CATTCCGCAAACTCGT-1	MEGF11_GBM
CATTCCGGTAGATGTA-1	GFAP_GBM
CATTCCGGTCAACCAT-1	Normal
CATTCCGGTCGCATTA-1	Normal
CATTCTAAGCAGCCCT-1	Normal
CATTCTAGTTGGACCC-1	Normal
CATTCTATCCGATGTA-1	Normal
CATTCTATCCTCCACA-1	Normal
CATTGAGCAACTCGTA-1	Normal
CATTGAGCAATCAAGA-1	Normal
CATTGCCCAGCTTCCT-1	Normal
CATTGCCCATGACACT-1	Normal
CATTGCCGTAGTCCTA-1	Normal
CATTGCCGTATCGCTA-1	MEGF11_GBM
CATTGCCTCTGTGCGG-1	GFAP_GBM
CATTGTTCATGCCGGT-1	Normal
CATTGTTGTATACCTG-1	VEGFA_GBM
CATTGTTTCCATTTAC-1	Normal
CATTGTTTCTCCATAT-1	GFAP_GBM
CATTTCAAGGTTCCAT-1	MEGF11_GBM
CATTTCAAGTTCCAGT-1	Normal
CATTTCACACGTAGTT-1	Normal
CATTTCATCGACGTCG-1	Normal
CCAAGCGGTAACCCTA-1	Normal
CCAAGCGGTATGGAAT-1	VEGFA_GBM
CCAAGCGGTCAAAGAT-1	GFAP_GBM
CCAAGCGTCCTACTGC-1	Normal
CCAATGACAAACTCGT-1	Normal
CCAATGAGTAAGCAAT-1	Normal
CCAATGAGTCGGAACA-1	Normal
CCAATGAGTTGTGTTG-1	Normal
CCAATGATCCGCACGA-1	GFAP_GBM
CCAATGATCTAGATCG-1	Normal
CCAATTTAGATCACTC-1	GFAP_GBM
CCAATTTCAACGACAG-1	MEGF11_GBM
CCAATTTCAGGTATGG-1	Normal
CCACAAACAACCGACC-1	Normal
CCACACTAGAGTTCGG-1	MEGF11_GBM
CCACACTAGGGATCTG-1	GFAP_GBM
CCACACTTCGCCTCTA-1	Normal
CCACCATAGCCACAAG-1	Normal
CCACCATGTAAGGCCA-1	GFAP_GBM
CCACCATGTAGTATAG-1	MEGF11_GBM
CCACCATGTGAAGCTG-1	Normal
CCACCATGTGGCAACA-1	Normal
CCACCATTCCGAACGC-1	Clone_2nd
CCACCATTCGTCAAAC-1	Normal
CCACGAGCAGTAGTTC-1	MEGF11_GBM
CCACGAGCATAACGGG-1	MEGF11_GBM
CCACGAGCATATAGCC-1	Normal
CCACGAGGTCTGCATA-1	Normal
CCACGTTAGCGTACAG-1	Normal
CCACGTTTCCCTTTGG-1	Normal
CCACTTGGTAGATCGG-1	Normal
CCATAAGAGGTTGACG-1	Normal
CCATAAGAGTAGGATT-1	Normal
CCATAAGCACCTGAAT-1	Normal
CCATAAGCACTGTGAT-1	GFAP_GBM
CCATAAGCATGGCTGC-1	MEGF11_GBM
CCATAAGGTAATGCGG-1	Normal
CCATAAGTCCGAGAAG-1	GFAP_GBM
CCATAAGTCTCAGAAC-1	Normal
CCATCACAGCGAACTG-1	MEGF11_GBM
CCATCACAGGTTAGTA-1	MEGF11_GBM
CCATCACCACGGGTAA-1	Normal
CCATCACGTAGGGTAC-1	Normal
CCATCACTCAGACTGT-1	MEGF11_GBM
CCCAACTCAACTCATG-1	Normal
CCCAACTCAAGTTCCA-1	MEGF11_GBM
CCCAACTCACGCGCAT-1	MEGF11_GBM
CCCAACTCATTCAGGT-1	Normal
CCCAACTGTAACTTCG-1	GFAP_GBM
CCCAACTGTTACGGAG-1	GFAP_GBM
CCCAACTGTTCAAACC-1	Normal
CCCAACTTCTCATTTG-1	MEGF11_GBM
CCCATTGAGGCAGGTT-1	Normal
CCCATTGCAGAGTTGG-1	MEGF11_GBM
CCCATTGTCCGATGTA-1	MEGF11_GBM
CCCATTGTCGCGTGAC-1	Normal
CCCGAAGAGAAACCCG-1	Normal
CCCGAAGAGAGGGTCT-1	GFAP_GBM
CCCGAAGAGGTAAACT-1	MEGF11_GBM
CCCGAAGCAAACCATC-1	Normal
CCCGGAACAAGTAGTA-1	MEGF11_GBM
CCCGGAAGTGATATAG-1	Normal
CCCTAACCATGCAGCC-1	Normal
CCCTAACGTTCTCTCG-1	GFAP_GBM
CCCTCAAAGAGCATCG-1	MEGF11_GBM
CCCTCAAAGGCTCTCG-1	Normal
CCCTCAACAGTTTCAG-1	Normal
CCCTCAATCACCTTGC-1	Normal
CCCTCAATCTTTGATC-1	Normal
CCCTCTCAGAGCAGAA-1	Normal
CCCTCTCAGTACTGTC-1	Normal
CCCTCTCCAAAGCTAA-1	Normal
CCCTCTCCAGCCCAGT-1	MEGF11_GBM
CCCTCTCGTACCGGCT-1	Normal
CCCTCTCGTCGATGCC-1	MEGF11_GBM
CCCTCTCGTGGTCAAG-1	Normal
CCCTCTCGTGTTCCTC-1	MEGF11_GBM
CCCTCTCGTGTTCGAT-1	MEGF11_GBM
CCCTCTCTCGGAGTGA-1	Normal
CCCTGATAGGTTACCT-1	Normal
CCCTGATAGTAGACCG-1	MEGF11_GBM
CCCTGATCAACCCTAA-1	Normal
CCCTGATGTATTGAGA-1	Normal
CCCTTAGAGGGCGAGA-1	Normal
CCCTTAGAGTAGAGTT-1	Normal
CCCTTAGGTAGACAAT-1	Normal
CCCTTAGGTGGCTTGC-1	MEGF11_GBM
CCCTTAGTCAAGCCCG-1	Normal
CCCTTAGTCATGCGGC-1	Normal
CCCTTAGTCTGTTGGA-1	Normal
CCGAACGCAAGCGAGT-1	MEGF11_GBM
CCGAACGTCAAACGTC-1	Normal
CCGAACGTCAAGGAGC-1	MEGF11_GBM
CCGATCTAGCATTGAA-1	Normal
CCGATCTTCTTCACGC-1	MEGF11_GBM
CCGATGGCACCTTCGT-1	Normal
CCGATGGCACGATTCA-1	Normal
CCGATGGGTCAGGCAA-1	Normal
CCGATGGTCCGGACGT-1	Normal
CCGATGGTCGAGGCAA-1	Normal
CCGATGGTCTTAATCC-1	Normal
CCGCAAGTCATGCCCT-1	Clone_2nd
CCGGACAAGACTTGTC-1	GFAP_GBM
CCGGACACACGAGGAT-1	GFAP_GBM
CCGGACACAGCTACAT-1	MEGF11_GBM
CCGGGTATCATAGGCT-1	Normal
CCGGTGAGTTCGTAAC-1	GFAP_GBM
CCGGTGATCCTAAACG-1	Normal
CCGTAGGTCCGACAGC-1	GFAP_GBM
CCGTGAGAGTCCTGCG-1	Normal
CCGTGAGCAGAGGGTT-1	Normal
CCGTGAGTCGCGTAGC-1	Normal
CCGTTCAAGTAATACG-1	Normal
CCGTTCAGTGCTGATT-1	Normal
CCGTTCATCAAGCTGT-1	Normal
CCTAACCAGGAAGTAG-1	VEGFA_GBM
CCTAACCCAGTTAGGG-1	GFAP_GBM
CCTAACCGTCACTTCC-1	Normal
CCTAACCGTGCGGTAA-1	Normal
CCTAACCGTTATGGTC-1	Normal
CCTAACCTCATCGCTC-1	Normal
CCTAACCTCATTTGTC-1	Normal
CCTAAGAAGTCCCAGC-1	MEGF11_GBM
CCTAAGACACTGCTTC-1	MEGF11_GBM
CCTAAGAGTCTGTCAA-1	Normal
CCTAAGATCCAACCAA-1	GFAP_GBM
CCTACGTAGCAAGTGC-1	Normal
CCTACGTAGCACCCAC-1	Normal
CCTACGTCACAGCCAC-1	GFAP_GBM
CCTACGTCACTGAGTT-1	Normal
CCTACGTGTGACCGAA-1	GFAP_GBM
CCTACGTTCTCTTCAA-1	GFAP_GBM
CCTATCGAGTCCCAGC-1	GFAP_GBM
CCTATCGTCCGCGGAT-1	Normal
CCTATCGTCTCAACCC-1	Normal
CCTCAACCAAGTGGAC-1	Normal
CCTCAACCATAGATCC-1	GFAP_GBM
CCTCAACGTCGGCCTA-1	Normal
CCTCACAAGAAACACT-1	MEGF11_GBM
CCTCACACACTCTCGT-1	Normal
CCTCACACAGTAACAA-1	Normal
CCTCACAGTTCGATTG-1	Normal
CCTCAGTCAGCAGAAC-1	Normal
CCTCAGTTCACCCTGT-1	Normal
CCTCAGTTCTCAACGA-1	Normal
CCTCATGAGCTGTCCG-1	MEGF11_GBM
CCTCATGCAAGACCTT-1	Normal
CCTCATGCACCGTACG-1	Normal
CCTCATGGTGGTGATG-1	GFAP_GBM
CCTCATGGTTCGTGCG-1	Normal
CCTCATGTCAAGTGGG-1	Normal
CCTCCAAAGCTTTCCC-1	Normal
CCTCCAAGTGTCTTCC-1	Normal
CCTCCAATCGGCGATC-1	Normal
CCTCCAATCGTACACA-1	GFAP_GBM
CCTCCAATCTAGAGCT-1	GFAP_GBM
CCTCCTCAGGAGGGTG-1	Normal
CCTCCTCGTATGTCTG-1	VEGFA_GBM
CCTCCTCGTCATCGGC-1	Normal
CCTCCTCTCATAGGCT-1	MEGF11_GBM
CCTCCTCTCCCTCGTA-1	Normal
CCTCTAGCAGCGTTGC-1	Normal
CCTCTAGCATGCGGTC-1	Normal
CCTCTAGTCCAAGCTA-1	Normal
CCTCTAGTCTAGATCG-1	Normal
CCTCTCCAGGGCTGAT-1	MEGF11_GBM
CCTCTCCCACTGTTCC-1	Normal
CCTCTCCCATTCAGCA-1	Normal
CCTCTCCGTAATTAGG-1	Normal
CCTCTCCTCAGACATC-1	VEGFA_GBM
CCTCTCCTCCCAAGTA-1	MEGF11_GBM
CCTCTCCTCGGCACTG-1	Normal
CCTGCATAGAAGCTGC-1	GFAP_GBM
CCTGCATAGCGGATCA-1	GFAP_GBM
CCTGCATAGGTCCAGA-1	Normal
CCTGTTGGTGTGCTTA-1	MEGF11_GBM
CCTGTTGTCCCACAGG-1	Normal
CCTTCAGAGTGCCCGT-1	MEGF11_GBM
CCTTCAGGTCAAGCCC-1	VEGFA_GBM
CCTTCAGGTGCGGTAA-1	VEGFA_GBM
CCTTCAGGTGTTTGCA-1	VEGFA_GBM
CCTTCAGGTTCGGGTC-1	Normal
CCTTCAGGTTTCCAAG-1	Normal
CCTTGTGAGCATTTCG-1	Normal
CCTTGTGTCACCTCGT-1	Normal
CCTTGTGTCGCGAAGA-1	Normal
CCTTGTGTCGGATAAA-1	Normal
CCTTGTGTCGTACACA-1	MEGF11_GBM
CCTTTGGCACTACGGC-1	MEGF11_GBM
CCTTTGGTCACATACG-1	GFAP_GBM
CCTTTGGTCAGTGTCA-1	GFAP_GBM
CCTTTGGTCTCCTGTG-1	Normal
CGAAGGACAATAGTGA-1	Normal
CGAAGGACACGCACCA-1	MEGF11_GBM
CGAAGGACACTGCGAC-1	Normal
CGAAGGACAGACACCC-1	Normal
CGAAGGAGTCCTCCTA-1	Normal
CGAAGGATCGTGGTAT-1	GFAP_GBM
CGAAGTTAGAAGCGAA-1	MEGF11_GBM
CGAAGTTAGTCTAGCT-1	Normal
CGAAGTTTCAACCGAT-1	Normal
CGAAGTTTCGGTTGTA-1	Normal
CGAATTGCACATGAAA-1	Normal
CGAATTGCAGGACAGT-1	Normal
CGAATTGGTGGTTTGT-1	Normal
CGAATTGTCTGAGAGG-1	Normal
CGAATTGTCTTGTGCC-1	MEGF11_GBM
CGACAGCCAAATTGGA-1	Normal
CGACAGCCATGACTCA-1	Normal
CGACAGCGTCTCAGGC-1	Normal
CGACAGCGTTTGACAC-1	Normal
CGACAGCTCAGGGTAG-1	Normal
CGAGAAGCAGCTGTTA-1	Normal
CGAGAAGCATGATAGA-1	GFAP_GBM
CGAGAAGGTAAGATAC-1	MEGF11_GBM
CGAGAAGGTCAGCTTA-1	MEGF11_GBM
CGAGGAAAGCATGAAT-1	Normal
CGAGGAAAGGGCAGTT-1	Normal
CGAGGAAAGTACCCTA-1	MEGF11_GBM
CGAGGAACAAGACTGG-1	GFAP_GBM
CGAGGAAGTAGAGGAA-1	Normal
CGAGGAAGTGTCGCTG-1	MEGF11_GBM
CGAGGAAGTTAGAGTA-1	GFAP_GBM
CGAGGAATCGGACGTC-1	MEGF11_GBM
CGAGGCTAGAGATCGC-1	Normal
CGAGGCTAGTGTACCT-1	Normal
CGAGGCTCACTGAGGA-1	VEGFA_GBM
CGAGGCTCAGTCCCGA-1	Normal
CGAGGCTGTAGAGGAA-1	Normal
CGAGGCTTCGATTCCC-1	Normal
CGAGTGCAGACCATGG-1	Normal
CGAGTGCAGATACGAT-1	MEGF11_GBM
CGAGTGCCATAAGATG-1	Normal
CGAGTGCGTAGAATGT-1	Normal
CGAGTGCGTCTCTCAC-1	VEGFA_GBM
CGAGTGCGTTCCGTTC-1	Normal
CGAGTTACAGTCGGAA-1	Normal
CGAGTTACAGTCGGTC-1	Normal
CGAGTTACATGGCTAT-1	Normal
CGAGTTATCATGCAGT-1	Normal
CGAGTTATCTTAGCAG-1	Normal
CGATCGGTCTGAGGTT-1	Normal
CGATGCGAGACGGTTG-1	VEGFA_GBM
CGATGCGGTCGATTCA-1	Normal
CGATGCGTCGGTTCAA-1	Normal
CGATGGCCACTGGATT-1	Normal
CGATGGCGTGTCCACG-1	MEGF11_GBM
CGATGGCGTTCCTAGA-1	Clone_2nd
CGATGGCTCCGTGGTG-1	Normal
CGATGGCTCGACTCCT-1	Normal
CGATGGCTCGTTCTAT-1	Normal
CGCAGGTGTCCAAAGG-1	Normal
CGCAGGTGTGTATTGC-1	Normal
CGCAGGTTCGGTCGAC-1	GFAP_GBM
CGCATAAAGACCATGG-1	GFAP_GBM
CGCATAAAGATGCAGC-1	MEGF11_GBM
CGCATAAAGATGGCGT-1	Normal
CGCATAAAGCTAATGA-1	Normal
CGCATAAAGTTAGTGA-1	GFAP_GBM
CGCATAAGTTCCTTGC-1	Normal
CGCATAAGTTCGTACA-1	MEGF11_GBM
CGCATAATCGCAATTG-1	Normal
CGCATGGTCAGTCATG-1	Normal
CGCCAGAAGCACTGGA-1	MEGF11_GBM
CGCCAGAAGGGCAATC-1	Normal
CGCCAGACATACAGCT-1	VEGFA_GBM
CGCCAGATCCGTTGAA-1	Normal
CGCCAGATCTCGTGAA-1	MEGF11_GBM
CGCCATTAGTGCACCC-1	GFAP_GBM
CGCCATTCAGTTTGGT-1	Normal
CGCCATTGTGCTATTG-1	Normal
CGCGTGAAGCGCTGCT-1	Normal
CGCGTGAAGTGTGTTC-1	Normal
CGCGTGACACCTAAAC-1	Normal
CGCGTGACATCGTCCT-1	Normal
CGCGTGAGTCTTACTT-1	GFAP_GBM
CGCGTGAGTGTAGTGG-1	Normal
CGCGTGAGTTGAGTCT-1	Normal
CGGAACCAGTCATTGC-1	Normal
CGGAACCGTATCAGGG-1	GFAP_GBM
CGGAACCGTCATAACC-1	Normal
CGGAACCGTGTTTCTT-1	Normal
CGGAACCTCACCTCAC-1	VEGFA_GBM
CGGAATTCAAATGATG-1	Normal
CGGAATTCACCTGCAG-1	Normal
CGGAATTGTAGAGATT-1	Normal
CGGAATTGTCATGGCC-1	Normal
CGGAATTGTTGGATCT-1	MEGF11_GBM
CGGAATTTCATTTGTC-1	Normal
CGGAATTTCTGTGCTC-1	GFAP_GBM
CGGACACCAACACAGG-1	Normal
CGGACACGTCATCGCG-1	Normal
CGGAGAAAGACAGCTG-1	Normal
CGGAGAAGTAGTCTTG-1	MEGF11_GBM
CGGAGAATCCATTTGT-1	MEGF11_GBM
CGGAGAATCTGAATGC-1	GFAP_GBM
CGGCAGTAGATTGAGT-1	GFAP_GBM
CGGCAGTAGTGACCTT-1	Normal
CGGCAGTCATGAAAGT-1	MEGF11_GBM
CGGCAGTGTAGTATAG-1	VEGFA_GBM
CGGCAGTGTCCAAAGG-1	Normal
CGGCAGTGTGCGAGTA-1	MEGF11_GBM
CGGCAGTGTGTAACGG-1	Normal
CGGGACTAGGTAAGAG-1	Normal
CGGGACTCAATTGGTC-1	MEGF11_GBM
CGGGACTCACAACGAG-1	GFAP_GBM
CGGGACTCAGTCTGGC-1	Normal
CGGGACTGTCGGCACT-1	MEGF11_GBM
CGGGACTGTGCAATAA-1	GFAP_GBM
CGGGCATAGGCCATAG-1	MEGF11_GBM
CGGGCATAGTGGTGAC-1	Normal
CGGGCATCAAGCACAG-1	Normal
CGGGCATGTACCTGTA-1	GFAP_GBM
CGGGCATGTATACCTG-1	Normal
CGGGCATGTGTTGAGG-1	Normal
CGGGCATTCGGTCAGC-1	Normal
CGGGTCACAATCTAGC-1	GFAP_GBM
CGGGTCACATGGGCAA-1	Normal
CGGGTCAGTATTTCCT-1	VEGFA_GBM
CGGGTGTCAACCAACT-1	Normal
CGGGTGTGTAAGCAAT-1	MEGF11_GBM
CGGGTGTGTGGCTTGC-1	Normal
CGGGTGTGTTTCGATG-1	GFAP_GBM
CGGGTGTTCTGTCCCA-1	MEGF11_GBM
CGGTCAGGTCCCGTGA-1	GFAP_GBM
CGGTCAGGTTATCCAG-1	Normal
CGTAAGTAGCCTCTGG-1	VEGFA_GBM
CGTAAGTGTAATACCC-1	MEGF11_GBM
CGTAAGTGTCTGTGTA-1	MEGF11_GBM
CGTAAGTTCCACAGCG-1	Normal
CGTAATGCACGCTGTG-1	GFAP_GBM
CGTAATGGTGACCGTC-1	MEGF11_GBM
CGTAATGGTGTATTGC-1	Normal
CGTAGTACACAGAGCA-1	Normal
CGTAGTAGTCTTCTAT-1	Normal
CGTAGTATCATCCTGC-1	Normal
CGTCAAACAGTGGGTA-1	Normal
CGTCAAATCAGACCTA-1	VEGFA_GBM
CGTCAAATCCATCCGT-1	MEGF11_GBM
CGTCAAATCCTCTAAT-1	Normal
CGTCCATCAGGCATGA-1	Normal
CGTCCATCAGGTTCAT-1	GFAP_GBM
CGTCCATCATCGGCCA-1	Normal
CGTCCATGTCCATACA-1	Normal
CGTCCATGTCTGTAGT-1	Normal
CGTCCATGTTAGCTAC-1	VEGFA_GBM
CGTCCATTCGGCCCAA-1	GFAP_GBM
CGTCCATTCTCAACCC-1	GFAP_GBM
CGTGAATAGCGCCTCA-1	Normal
CGTGAATAGGACAAGA-1	Clone_2nd
CGTGAATCACCTGCAG-1	Normal
CGTGAATTCCGTCAAA-1	Normal
CGTGATAAGCAGGGAG-1	Normal
CGTGATAAGGCGCTCT-1	MEGF11_GBM
CGTGATAAGGTGGCTA-1	MEGF11_GBM
CGTGATAAGTATAGAC-1	Normal
CGTGATAAGTTCCTGA-1	Normal
CGTGATACAAGAATGT-1	MEGF11_GBM
CGTGATACAGTGGTGA-1	Normal
CGTGATATCGTGGCTG-1	Normal
CGTGCTTAGCCGAACA-1	Normal
CGTGCTTGTTCCTAAG-1	Normal
CGTGCTTTCAATCGGT-1	Normal
CGTGCTTTCACTTGTT-1	Normal
CGTGCTTTCCTTGACC-1	MEGF11_GBM
CGTGTCTAGATGGGCT-1	Normal
CGTGTCTGTTTACGTG-1	VEGFA_GBM
CGTGTCTTCCGAGCTG-1	Normal
CGTTAGAAGGAATCGC-1	Normal
CGTTAGACAAACCATC-1	GFAP_GBM
CGTTAGAGTAGACAGC-1	Normal
CGTTAGAGTCATAAAG-1	MEGF11_GBM
CGTTAGATCATGACAC-1	GFAP_GBM
CGTTAGATCCAAATGC-1	Normal
CGTTAGATCCCGTGAG-1	Normal
CGTTCTGTCGTAGGAG-1	Normal
CGTTGGGAGCTAGTTC-1	Normal
CGTTGGGAGTTCTCTT-1	MEGF11_GBM
CGTTGGGCAATAACGA-1	Normal
CGTTGGGCACAGTCGC-1	Normal
CGTTGGGCAGGAGGTT-1	Normal
CTAACCCAGCTTCGTA-1	VEGFA_GBM
CTAACCCCACCCAATA-1	Normal
CTAACCCTCACTGGTA-1	VEGFA_GBM
CTAACCCTCAGTGGGA-1	Normal
CTAACCCTCGAACTCA-1	Normal
CTAACCCTCGACCACG-1	Normal
CTAACTTAGAGAGAAC-1	Normal
CTAACTTCACAAGCCC-1	Normal
CTAACTTGTTAAGGGC-1	GFAP_GBM
CTAAGTGCATGACGAG-1	Clone_2nd
CTAAGTGGTAAGTAGT-1	Normal
CTAAGTGGTCTATGAC-1	Normal
CTAAGTGGTTCAGTAC-1	GFAP_GBM
CTAAGTGGTTGCATTG-1	GFAP_GBM
CTAAGTGGTTGTCTAG-1	Normal
CTAAGTGTCATCTCTA-1	GFAP_GBM
CTACAGAGTCACTACA-1	Clone_2nd
CTACAGATCTCGACGG-1	Normal
CTACCCAAGCGCGTTC-1	MEGF11_GBM
CTACCCACACCGTCGA-1	Normal
CTACCCACAGTTCACA-1	GFAP_GBM
CTACCCATCAACTTTC-1	Normal
CTACCCATCGCGGTAC-1	Normal
CTACCTGAGTCCCAGC-1	GFAP_GBM
CTACCTGCAGCCTACG-1	Normal
CTACCTGCATGCACTA-1	Normal
CTACCTGTCGAAGCAG-1	Normal
CTACCTGTCTACAGGT-1	Normal
CTACGGGAGATCCGAG-1	GFAP_GBM
CTACGGGAGGTAAGTT-1	VEGFA_GBM
CTACGGGAGTCCCTAA-1	GFAP_GBM
CTACGGGCAACACTAC-1	GFAP_GBM
CTACTATAGCCTGTGC-1	Normal
CTACTATCAATTCGTG-1	Normal
CTACTATGTAGGTAGC-1	Normal
CTACTATTCGTTATCT-1	MEGF11_GBM
CTACTATTCTGGTCAA-1	Normal
CTAGACAAGCACTCAT-1	Normal
CTAGACAAGCTGAAGC-1	MEGF11_GBM
CTAGACACATAGACTC-1	GFAP_GBM
CTAGACACATGAGATA-1	Clone_2nd
CTAGACAGTGTCATCA-1	VEGFA_GBM
CTAGACATCTCTGCCA-1	MEGF11_GBM
CTAGGTAAGTCGAGGT-1	Normal
CTAGGTAAGTTTGGCT-1	MEGF11_GBM
CTAGGTACATCCGTTC-1	GFAP_GBM
CTAGGTAGTTGGGTTT-1	GFAP_GBM
CTATAGGCAATTGCGT-1	GFAP_GBM
CTATAGGCACAGCTTA-1	Normal
CTATAGGCAGTCCGTG-1	MEGF11_GBM
CTATAGGCATCCTTGC-1	GFAP_GBM
CTATAGGGTCTCGCGA-1	GFAP_GBM
CTATAGGTCATCCCGT-1	VEGFA_GBM
CTATAGGTCGAAGAAT-1	MEGF11_GBM
CTATAGGTCTAAGCCA-1	Normal
CTATCCGAGAGGGTCT-1	Normal
CTATCCGAGCCTTTGA-1	Normal
CTATCCGGTCTAGGTT-1	Normal
CTATCCGTCGAAATCC-1	GFAP_GBM
CTATCTAAGTGGTTGG-1	GFAP_GBM
CTATCTACAACCGACC-1	GFAP_GBM
CTATCTACACGCCACA-1	Normal
CTATCTACACGGTCTG-1	Normal
CTATCTATCAATCTCT-1	VEGFA_GBM
CTATCTATCTCCCTAG-1	MEGF11_GBM
CTCAACCAGGCGTTGA-1	GFAP_GBM
CTCAACCCAACACTAC-1	VEGFA_GBM
CTCAACCCAATACGCT-1	Normal
CTCAACCCAGACAAAT-1	MEGF11_GBM
CTCAACCCAGCAGACA-1	Normal
CTCAACCGTCAGCGTC-1	Normal
CTCAACCGTGATACAA-1	Normal
CTCAAGAAGGCTTCCG-1	MEGF11_GBM
CTCAAGACAAGCTGTT-1	Normal
CTCAAGAGTGCTCGTG-1	Normal
CTCAAGAGTTCCGCTT-1	MEGF11_GBM
CTCAATTAGGGATCAC-1	Normal
CTCAATTCATGTAACC-1	Normal
CTCAATTGTCACTCGG-1	Normal
CTCAATTTCAACGAGG-1	MEGF11_GBM
CTCAATTTCTTTGCGC-1	Normal
CTCACTGCAGCCTATA-1	Clone_2nd
CTCACTGCATTGCAAC-1	Normal
CTCACTGGTCTACATG-1	Normal
CTCAGAAAGTACCATC-1	Clone_2nd
CTCAGAACAACGACTT-1	Normal
CTCAGAAGTGGCTACC-1	MEGF11_GBM
CTCAGGGGTCCCTCAT-1	Normal
CTCAGGGGTGCTCTCT-1	GFAP_GBM
CTCAGGGGTTGTGGCC-1	Normal
CTCAGTCAGTGAATAC-1	GFAP_GBM
CTCAGTCGTCACCTTC-1	Normal
CTCAGTCGTCGTTGGC-1	Normal
CTCAGTCGTTGTCATG-1	Normal
CTCAGTCTCAGCCCAG-1	MEGF11_GBM
CTCAGTCTCCATATGG-1	Normal
CTCATCGAGACGACTG-1	Normal
CTCATCGCAGAGTTCT-1	Normal
CTCATGCAGGTGCCAA-1	Normal
CTCATGCCACAGCGCT-1	VEGFA_GBM
CTCATGCGTCTTCTAT-1	MEGF11_GBM
CTCATGCGTGCCTATA-1	Normal
CTCATGCTCTGGCCGA-1	GFAP_GBM
CTCATTAAGCGTGCTC-1	GFAP_GBM
CTCATTAGTAATTAGG-1	Normal
CTCCAACAGTTTGAGA-1	Normal
CTCCAACCAATGAGCG-1	Normal
CTCCAACCAGGATCTT-1	MEGF11_GBM
CTCCAACCATCCGAGC-1	MEGF11_GBM
CTCCACAAGAAGTATC-1	MEGF11_GBM
CTCCACAAGCTATCCA-1	Normal
CTCCACAAGTGGTGGT-1	MEGF11_GBM
CTCCACAGTGACCTGC-1	Normal
CTCCATGTCTCTGACC-1	Normal
CTCCCAAAGGTCGTGA-1	MEGF11_GBM
CTCCCAACAAACGTGG-1	MEGF11_GBM
CTCCCAACACCAGACC-1	Normal
CTCCCAACACTACAGT-1	Normal
CTCCCAAGTACTAAGA-1	Normal
CTCCCAAGTCTTTCTA-1	Normal
CTCCCAAGTGCAAGAC-1	Normal
CTCCCAATCACCGGTG-1	Normal
CTCCCAATCCCATAAG-1	MEGF11_GBM
CTCCCAATCTGGAGAG-1	Normal
CTCCCTCAGTAAGGGA-1	Normal
CTCCCTCCAGTGACCC-1	GFAP_GBM
CTCCCTCGTAACTGCT-1	Normal
CTCCCTCTCATTTGTC-1	GFAP_GBM
CTCCGATCACCATATG-1	Normal
CTCCGATCAGGTGGAT-1	MEGF11_GBM
CTCCGATCATATAGCC-1	VEGFA_GBM
CTCCGATGTCTTGAGT-1	GFAP_GBM
CTCCGATGTGTGGTCC-1	GFAP_GBM
CTCCGATTCGCCTCTA-1	Normal
CTCCGATTCTTCTGTA-1	Normal
CTCCTCCAGAGGGTCT-1	Normal
CTCCTCCAGATGGGCT-1	Normal
CTCCTCCGTGCCTACG-1	Normal
CTCCTCCGTTTCCAAG-1	Normal
CTCCTCCTCTAGTTCT-1	Normal
CTCCTTTGTCTGTTAG-1	MEGF11_GBM
CTCCTTTTCACGATAC-1	MEGF11_GBM
CTCCTTTTCGAAGCAG-1	MEGF11_GBM
CTCGAGGCAACTCCAA-1	Normal
CTCGAGGCATCTCCCA-1	Clone_2nd
CTCGAGGCATCTTTCA-1	Normal
CTCGAGGTCCGTCCTA-1	VEGFA_GBM
CTCTCAGCACGAAAGC-1	Normal
CTCTCAGCAGATTCGT-1	Normal
CTCTCAGCATGCAGCC-1	Normal
CTCTCAGGTCGAGCTC-1	Normal
CTCTCAGGTTGATCGT-1	MEGF11_GBM
CTCTCGAAGCCTGAGA-1	Normal
CTCTCGAGTAGGTAGC-1	Normal
CTCTCGAGTTAGGAGC-1	VEGFA_GBM
CTCTGGTAGGAAACGA-1	Normal
CTCTGGTCAGCTGGTC-1	GFAP_GBM
CTCTGGTCATGGGAAC-1	MEGF11_GBM
CTCTGGTGTGGTCCCA-1	MEGF11_GBM
CTCTGGTGTTCGGTTA-1	MEGF11_GBM
CTCTGGTTCTTGTGCC-1	Normal
CTGAATGGTAGAGACC-1	Normal
CTGAGCGAGTTGGACG-1	GFAP_GBM
CTGAGCGCACACCTAA-1	Normal
CTGAGGCGTCACCTTC-1	Normal
CTGAGGCGTCGAACAG-1	Normal
CTGAGGCTCTCGTCAC-1	Normal
CTGATCCCAACCGTGC-1	Normal
CTGATCCCAAGGATGC-1	Normal
CTGATCCCAATTCTCT-1	Normal
CTGATCCCATTCAGCA-1	GFAP_GBM
CTGATCCGTCAACGCC-1	VEGFA_GBM
CTGATCCGTCAAGGCA-1	MEGF11_GBM
CTGATCCGTCGAATGG-1	MEGF11_GBM
CTGATCCGTTTACGAC-1	Normal
CTGATCCTCCGATGTA-1	Normal
CTGCAGGAGCTAAACA-1	Normal
CTGCAGGCACCATAAC-1	Normal
CTGCAGGGTATCGCGC-1	GFAP_GBM
CTGCAGGGTCCGTACG-1	MEGF11_GBM
CTGCAGGGTGTCTCCT-1	VEGFA_GBM
CTGCAGGGTTCGAAGG-1	MEGF11_GBM
CTGCAGGTCCACAGGC-1	GFAP_GBM
CTGCATCCACGTACTA-1	Normal
CTGCATCGTCAACACT-1	Normal
CTGCATCTCCACTTTA-1	Normal
CTGCATCTCTCGACGG-1	GFAP_GBM
CTGCCATCACGTACAT-1	Normal
CTGCCATCATTCACCC-1	Normal
CTGCCATGTATTGAGA-1	Normal
CTGCCATTCCATGAGT-1	VEGFA_GBM
CTGCCTAAGAGTGTGC-1	Normal
CTGCCTAAGTTACGTC-1	GFAP_GBM
CTGCCTACAAACCACT-1	Normal
CTGCCTACACCAACAT-1	MEGF11_GBM
CTGCCTATCCCACAGG-1	Normal
CTGCCTATCGAACGCC-1	VEGFA_GBM
CTGCCTATCGAGAAAT-1	Normal
CTGCGAGAGACTTCAC-1	Normal
CTGCGAGAGATCGCTT-1	Normal
CTGCGAGAGGCCGCTT-1	GFAP_GBM
CTGCGAGGTACTCAAC-1	Normal
CTGCGAGGTCTTTCTA-1	Normal
CTGCTCAAGAGGATCC-1	Normal
CTGCTCAAGATCACTC-1	MEGF11_GBM
CTGCTCATCAACGCTA-1	Normal
CTGCTCATCCGTGTCT-1	Normal
CTGCTCATCCTAGCGG-1	Normal
CTGCTCATCTTAGCTT-1	VEGFA_GBM
CTGGACGCATTCTCCG-1	Normal
CTGGACGGTATCTCTT-1	MEGF11_GBM
CTGGACGGTCTCCCTA-1	Normal
CTGGCAGCACTGGCCA-1	Normal
CTGGCAGGTTAAGACA-1	Normal
CTGGCAGTCTCGCGTT-1	MEGF11_GBM
CTGGCAGTCTGAGGCC-1	Normal
CTGGTCTAGAAGGTAG-1	Clone_2nd
CTGGTCTCAAGATGTA-1	Normal
CTGGTCTGTATGAAGT-1	MEGF11_GBM
CTGGTCTGTATTGAGA-1	MEGF11_GBM
CTGGTCTGTTCCGCTT-1	Normal
CTGTACCCACTTGTCC-1	VEGFA_GBM
CTGTACCCAGAGGACT-1	VEGFA_GBM
CTGTACCCAGGAATCG-1	GFAP_GBM
CTGTACCGTTGGGAAC-1	MEGF11_GBM
CTGTAGAGTCGGTACC-1	GFAP_GBM
CTGTATTAGAGTCAGC-1	Normal
CTGTATTAGCACCGTC-1	Normal
CTGTATTCAGAGATGC-1	Normal
CTGTATTGTAGAGGAA-1	MEGF11_GBM
CTGTATTGTCCGCAGT-1	Normal
CTGTATTTCCGAACGC-1	VEGFA_GBM
CTGTCGTAGAGGTTTA-1	GFAP_GBM
CTGTCGTAGCCGATTT-1	Normal
CTGTCGTCACCGTGGT-1	GFAP_GBM
CTGTCGTGTATTGACC-1	MEGF11_GBM
CTGTCGTTCACCGACG-1	Normal
CTGTCGTTCATGCGGC-1	Normal
CTGTCGTTCCACGAAT-1	MEGF11_GBM
CTGTGAAAGCGACTAG-1	Normal
CTGTGAAAGCTAATGA-1	GFAP_GBM
CTGTGAACAAATACGA-1	VEGFA_GBM
CTGTGAATCTCGTCAC-1	Normal
CTGTGGGGTACACGCC-1	Normal
CTGTGGGGTGGATACG-1	MEGF11_GBM
CTGTGGGGTGGATCGA-1	VEGFA_GBM
CTGTGGGTCCCATAAG-1	Normal
CTGTGGGTCGAAATCC-1	VEGFA_GBM
CTTACCGAGAGGACTC-1	Normal
CTTACCGCATCCGCGA-1	GFAP_GBM
CTTACCGGTGAGACGT-1	Normal
CTTAGGAAGAATTGCA-1	Normal
CTTAGGAAGACGCCAA-1	Normal
CTTAGGAAGCACCTGC-1	GFAP_GBM
CTTAGGACACAGTCGC-1	Normal
CTTAGGACACCCTATC-1	Normal
CTTAGGACAGCCCAGT-1	Normal
CTTAGGATCTTCGACC-1	Normal
CTTCAATAGACTAGAT-1	Normal
CTTCAATAGCCAACCC-1	VEGFA_GBM
CTTCAATAGGGTTTCT-1	MEGF11_GBM
CTTCAATAGGTGATAT-1	Normal
CTTCAATAGTCATGCT-1	Normal
CTTCAATCATCGAACT-1	Normal
CTTCAATGTCGCGGTT-1	Normal
CTTCAATTCATTCATC-1	Normal
CTTCAATTCCCGTGAG-1	MEGF11_GBM
CTTCCGAAGCTCGGCT-1	Normal
CTTCCGATCGGCTGGT-1	VEGFA_GBM
CTTCCTTAGCCTCATA-1	MEGF11_GBM
CTTCCTTAGCGTTCAT-1	VEGFA_GBM
CTTCCTTAGGAAAGTG-1	MEGF11_GBM
CTTCCTTCACATAGCT-1	Clone_2nd
CTTCCTTCATCGGAGA-1	Normal
CTTCCTTGTCTCTCTG-1	GFAP_GBM
CTTCCTTGTGAGAGGG-1	Normal
CTTCCTTGTGCTGATT-1	Normal
CTTCCTTTCCCAAGCG-1	MEGF11_GBM
CTTCCTTTCGGCGATC-1	GFAP_GBM
CTTCGGTCAAATCGGG-1	Normal
CTTCGGTTCATTGCGA-1	Normal
CTTCGGTTCGGTCGGT-1	GFAP_GBM
CTTCTAACACCGGCTA-1	MEGF11_GBM
CTTCTAACAGGCTATT-1	Normal
CTTCTCTGTGGCTGCT-1	GFAP_GBM
CTTCTCTTCCCGGTAG-1	Normal
CTTGAGAAGTCACACT-1	Normal
CTTGAGAGTAGATCGG-1	MEGF11_GBM
CTTGAGAGTCTTGCTC-1	MEGF11_GBM
CTTGAGATCAGACCCG-1	Normal
CTTGAGATCAGAGCAG-1	Normal
CTTGATTGTCAACCTA-1	Normal
CTTGATTTCCGGGACT-1	Normal
CTTTCAAAGAATACAC-1	Normal
CTTTCAACATACAGCT-1	MEGF11_GBM
CTTTCAAGTCCTGAAT-1	Normal
CTTTCAATCGCAGATT-1	Normal
CTTTCAATCGCCAACG-1	MEGF11_GBM
CTTTCGGAGAGCCCAA-1	VEGFA_GBM
CTTTCGGCATACTGTG-1	Normal
CTTTCGGGTCTCAGGC-1	VEGFA_GBM
CTTTCGGGTGAGCCAA-1	Normal
CTTTCGGTCGCTCTCA-1	VEGFA_GBM
CTTTCGGTCTAACGCA-1	Normal
GAAACCTAGAGTCACG-1	Normal
GAAACCTGTTGGTAGG-1	Normal
GAAACCTTCATGAAAG-1	MEGF11_GBM
GAAACCTTCCGTGTAA-1	Normal
GAAACCTTCTAGTCAG-1	Normal
GAAATGAAGACCAAGC-1	VEGFA_GBM
GAAATGACACTCGATA-1	Normal
GAAATGAGTTCTCCAC-1	Normal
GAAATGATCTGAGAAA-1	Normal
GAACACTAGCCGATTT-1	Normal
GAACACTCAGCACCCA-1	Normal
GAACACTTCAATCCAG-1	Normal
GAACACTTCTGAGCAT-1	Normal
GAACGTTAGTTACGAA-1	VEGFA_GBM
GAACGTTGTCGGCACT-1	GFAP_GBM
GAACGTTTCCGTGTGG-1	MEGF11_GBM
GAACGTTTCTCGAGTA-1	Normal
GAACTGTAGATACAGT-1	GFAP_GBM
GAACTGTCAATTCACG-1	Normal
GAAGAATAGCACGTCC-1	GFAP_GBM
GAAGAATAGTGCCGAA-1	MEGF11_GBM
GAAGAATCATCGCCTT-1	Normal
GAAGAATGTGGAGAAA-1	Normal
GAAGCCCAGTTAACGA-1	Normal
GAAGCCCCAACACTAC-1	Clone_2nd
GAAGCCCCACGGTGTC-1	Normal
GAAGCCCGTGCACAAG-1	Normal
GAAGCCCGTTATGGTC-1	Normal
GAAGCCCTCAAACGAA-1	Normal
GAAGCCCTCCCATAAG-1	MEGF11_GBM
GAAGCCCTCCCGTAAA-1	MEGF11_GBM
GAAGCCCTCGCTCTAC-1	GFAP_GBM
GAAGCGAAGAAATGGG-1	Normal
GAAGCGAGTGTTTCTT-1	MEGF11_GBM
GAAGGACCACACAGCC-1	Normal
GAAGGACTCATTCACT-1	GFAP_GBM
GAAGGACTCCACAGCG-1	Normal
GAAGGGTCAAATACAG-1	MEGF11_GBM
GAAGGGTCAAATGAAC-1	Normal
GAAGGGTCACAGTATC-1	Normal
GAAGGGTCATTGACAC-1	Normal
GAAGTAAAGAGTGTGC-1	Normal
GAAGTAAAGTTCCGGC-1	Normal
GAAGTAACATGGACAG-1	MEGF11_GBM
GAAGTAACATTCAGCA-1	MEGF11_GBM
GAAGTAAGTATGCGTT-1	Normal
GAAGTAATCAATCTTC-1	GFAP_GBM
GAAGTAATCCGTTGGG-1	Normal
GAAGTAATCTATTTCG-1	GFAP_GBM
GAATAGAAGGGCAAGG-1	Normal
GAATAGAAGTGCCGAA-1	Normal
GAATAGACAGTAGAGC-1	Normal
GAATAGACATCTGCGG-1	Normal
GAATAGAGTCTCGGAC-1	MEGF11_GBM
GAATAGATCCGTATAG-1	Normal
GAATCACAGGCACTCC-1	Normal
GAATCACTCCACTTTA-1	Normal
GAATCGTCACCATAAC-1	GFAP_GBM
GAATCGTCAGACCAGA-1	Normal
GAATCGTGTCCAAGAG-1	Normal
GAATCGTGTCGCCACA-1	Normal
GAATCGTGTTGCCGCA-1	Normal
GAATCGTTCCGTGGCA-1	Normal
GAATCGTTCGTCTCAC-1	Normal
GACACGCAGCAAATGT-1	Normal
GACACGCAGGACTATA-1	VEGFA_GBM
GACACGCAGGCTGAAC-1	GFAP_GBM
GACACGCAGTTCCGGC-1	Normal
GACACGCGTAGTCTTG-1	Normal
GACACGCGTGACCGTC-1	Normal
GACACGCGTTGTTGCA-1	Normal
GACAGCCCACCCTTGT-1	MEGF11_GBM
GACAGCCCATATGCGT-1	Normal
GACAGCCGTGAAGCGT-1	Normal
GACAGCCTCTGCATAG-1	GFAP_GBM
GACATCACACAATTCG-1	GFAP_GBM
GACATCACATCGATAC-1	Normal
GACATCAGTCTTAGTG-1	Normal
GACATCAGTGGCTTGC-1	Normal
GACATCAGTGTCCACG-1	GFAP_GBM
GACCAATAGCTCGTGC-1	GFAP_GBM
GACCAATAGTTGCTCA-1	GFAP_GBM
GACCAATGTACGAGTG-1	MEGF11_GBM
GACCAATGTATCCTCC-1	Normal
GACCAATGTCAACCAT-1	GFAP_GBM
GACCCAGAGGTTACAA-1	GFAP_GBM
GACCCAGCAAGACAAT-1	VEGFA_GBM
GACCCAGCACTCGATA-1	Normal
GACCCAGCAGAGTGTG-1	VEGFA_GBM
GACCCAGCAGGAAGTC-1	Normal
GACCCAGGTAGGTTTC-1	GFAP_GBM
GACCCAGGTCATAACC-1	GFAP_GBM
GACCCAGGTCGATTCA-1	Normal
GACCCAGGTCTTTCTA-1	Normal
GACCCAGTCTCAATCT-1	MEGF11_GBM
GACCCAGTCTGTAAGC-1	Normal
GACCCTTGTGTCCAAT-1	VEGFA_GBM
GACCCTTTCCAGGACC-1	GFAP_GBM
GACCCTTTCCGTAGTA-1	GFAP_GBM
GACCCTTTCGCATGAT-1	Normal
GACCGTGAGATGACAT-1	Normal
GACCGTGCAGATTCGT-1	Normal
GACCGTGTCAATGCAC-1	Normal
GACCTTCAGTATGGAT-1	Normal
GACCTTCCATTAGGCT-1	Normal
GACCTTCGTAAGATTG-1	Normal
GACCTTCGTTGGACTT-1	Normal
GACCTTCTCACCATCC-1	GFAP_GBM
GACCTTCTCACCGCTT-1	Normal
GACGCTGAGGTGCTTT-1	Normal
GACGCTGAGTACAACA-1	Normal
GACGCTGCATAATCCG-1	Normal
GACGCTGTCTATCCAT-1	Normal
GACGTTAAGACATAGT-1	VEGFA_GBM
GACGTTAAGCCACCGT-1	MEGF11_GBM
GACGTTAAGCCTTCTC-1	Normal
GACGTTAAGGGCAGTT-1	GFAP_GBM
GACGTTACAACTGCTA-1	Normal
GACGTTAGTTCTGACA-1	Normal
GACGTTATCACCTTAT-1	Normal
GACTATGAGTCGAAAT-1	MEGF11_GBM
GACTATGCAACTGGTT-1	MEGF11_GBM
GACTATGGTAGTGATA-1	Normal
GACTATGGTCAAAGTA-1	MEGF11_GBM
GACTATGGTGCCCGTA-1	Normal
GACTCAAAGAGATCGC-1	Normal
GACTCAACAATAGAGT-1	GFAP_GBM
GACTCAACACTGCATA-1	Normal
GACTCAACAGAGTGAC-1	MEGF11_GBM
GACTCAACAGCATTGT-1	Normal
GACTCAATCCAACACA-1	GFAP_GBM
GACTCAATCGCACGAC-1	Normal
GACTCTCCACCACATA-1	Normal
GACTCTCCACCTGATA-1	Normal
GACTCTCGTAGCTGCC-1	MEGF11_GBM
GACTCTCGTAGTTCCA-1	Normal
GACTCTCGTCACCGAC-1	Normal
GACTCTCGTCCGGACT-1	Normal
GACTCTCTCCCATAGA-1	MEGF11_GBM
GACTCTCTCGTTACCC-1	Normal
GACTGATAGACGGTCA-1	Normal
GACTGATAGCCTCTTC-1	Normal
GACTGATGTTACGCCG-1	Normal
GACTGATTCATGCATG-1	VEGFA_GBM
GACTGATTCCAGTTCC-1	Normal
GACTTCCAGTGCGACA-1	Normal
GACTTCCCACTTTAGG-1	Normal
GACTTCCCAGGATTCT-1	Normal
GACTTCCGTAGAGCTG-1	Normal
GACTTCCGTATGAGAT-1	Normal
GAGAAATAGAATTGTG-1	Normal
GAGAAATAGCATTGTC-1	MEGF11_GBM
GAGAAATAGTATGCAA-1	MEGF11_GBM
GAGAAATCAACAGCCC-1	Normal
GAGAAATCAGTGTGCC-1	Normal
GAGAAATGTCTCTCTG-1	Normal
GAGAAATGTGCATGAG-1	Normal
GAGAAATGTTATAGAG-1	Normal
GAGAAATTCAACCTTT-1	Normal
GAGACCCCAATTTCCT-1	VEGFA_GBM
GAGACCCCAGAGGCTA-1	Normal
GAGACCCGTAACGTTC-1	Normal
GAGACCCGTCACTACA-1	GFAP_GBM
GAGACCCGTCTTACTT-1	Normal
GAGACCCGTGCTGCAC-1	Normal
GAGACTTAGCGTCAGA-1	Normal
GAGACTTAGCTGGAGT-1	GFAP_GBM
GAGACTTAGGGTAATT-1	MEGF11_GBM
GAGACTTCAGCCGGTT-1	Normal
GAGACTTCAGTATACC-1	Normal
GAGACTTCATTGTGCA-1	Normal
GAGACTTTCCATTGCC-1	GFAP_GBM
GAGACTTTCTTGGTGA-1	Normal
GAGAGGTAGCTCCACG-1	VEGFA_GBM
GAGAGGTAGGACATCG-1	Normal
GAGAGGTCAAATGGAT-1	MEGF11_GBM
GAGAGGTCAACCAATC-1	Normal
GAGAGGTGTAACATCC-1	Normal
GAGAGGTTCTCGTGGG-1	MEGF11_GBM
GAGATGGCAGGACGAT-1	MEGF11_GBM
GAGATGGGTGAGTCAG-1	Normal
GAGATGGTCAAGGAGC-1	MEGF11_GBM
GAGCCTGAGCAGCGAT-1	GFAP_GBM
GAGCCTGAGTCATTGC-1	Normal
GAGCCTGAGTGGTCAG-1	GFAP_GBM
GAGCCTGAGTGGTTGG-1	Normal
GAGCCTGCAATACGAA-1	Normal
GAGCCTGGTAACCCTA-1	MEGF11_GBM
GAGCCTGGTACCAGAG-1	MEGF11_GBM
GAGCCTGGTCCACAGC-1	Normal
GAGCCTGGTTCACCGG-1	Normal
GAGCCTGGTTTCTATC-1	Normal
GAGCCTGTCGAGTCTA-1	Normal
GAGCTGCAGCAGCCCT-1	Normal
GAGCTGCCAACACAGG-1	MEGF11_GBM
GAGCTGCTCTTAGCCC-1	MEGF11_GBM
GAGGCAAAGAGGTGCT-1	VEGFA_GBM
GAGGCAAAGGCCGCTT-1	GFAP_GBM
GAGGCAAAGGGCAGTT-1	MEGF11_GBM
GAGGCAAAGTACTGTC-1	Normal
GAGGCAACAAGGATGC-1	GFAP_GBM
GAGGCAACAGGAGGAG-1	MEGF11_GBM
GAGGCAATCCACTTTA-1	Normal
GAGGCCTAGGTTTACC-1	Normal
GAGGCCTCATATTCGG-1	GFAP_GBM
GAGGGATTCAGACCTA-1	Normal
GAGGGATTCCCAGGAC-1	VEGFA_GBM
GAGGGATTCTAGACCA-1	Normal
GAGGGTAAGAGCATCG-1	Normal
GAGGGTAAGGGAACAA-1	Normal
GAGGGTACAGCCTATA-1	Normal
GAGGGTAGTCCAACGC-1	MEGF11_GBM
GAGGGTAGTTTCGTGA-1	Normal
GAGGGTATCTCAATCT-1	MEGF11_GBM
GAGTCATAGCCAACCC-1	MEGF11_GBM
GAGTCATCAAGTGGTG-1	Normal
GAGTCATGTCACTCAA-1	MEGF11_GBM
GAGTCATGTCCAACGC-1	Normal
GAGTCATGTTACCCTC-1	GFAP_GBM
GAGTCATTCGTAGAGG-1	Normal
GAGTCATTCGTGTGAT-1	Normal
GAGTCTAAGGAGGCAG-1	Normal
GAGTCTACACCGTCTT-1	MEGF11_GBM
GAGTCTACACGACCTG-1	Normal
GAGTCTAGTCCACACG-1	Normal
GAGTGAGGTACAAAGT-1	Normal
GAGTGAGGTACGGGAT-1	Normal
GAGTGAGGTGGGAGAG-1	Normal
GAGTGAGGTGGTGATG-1	Normal
GAGTGTTAGCTGGCTC-1	Normal
GAGTGTTCAGTGTGGA-1	MEGF11_GBM
GAGTGTTCATGGAACG-1	Normal
GAGTGTTGTATGAGCG-1	MEGF11_GBM
GAGTGTTGTTCTTGCC-1	Normal
GAGTTACAGAAAGTCT-1	Normal
GAGTTACAGGACAACC-1	GFAP_GBM
GAGTTACTCGCTTTAT-1	MEGF11_GBM
GAGTTGTCAACCGACC-1	Normal
GAGTTGTCAATAAGGT-1	Normal
GAGTTGTGTCTACGTA-1	GFAP_GBM
GAGTTGTGTGTGGTCC-1	MEGF11_GBM
GAGTTTGCAATTCTTC-1	GFAP_GBM
GAGTTTGGTAATGCTC-1	Normal
GAGTTTGTCCTCTTTC-1	MEGF11_GBM
GAGTTTGTCCTGGCTT-1	GFAP_GBM
GAGTTTGTCGTAGAGG-1	Normal
GAGTTTGTCTCTCCGA-1	Normal
GATAGAAAGCCTTGAT-1	Normal
GATAGAACATTGACTG-1	Normal
GATAGCTAGCTAAGTA-1	Normal
GATAGCTAGCTCCCTT-1	Normal
GATAGCTCAAGAGATT-1	GFAP_GBM
GATAGCTGTTCACGAT-1	Normal
GATAGCTGTTTGTTGG-1	Normal
GATAGCTTCCAAATGC-1	Normal
GATAGCTTCTACTGCC-1	VEGFA_GBM
GATCACACAATTGAGA-1	GFAP_GBM
GATCACACATCGAAGG-1	Normal
GATCACACATGGCTAT-1	Normal
GATCACAGTCGCAGTC-1	Normal
GATCACAGTGGATCAG-1	Normal
GATCACATCCCTGGTT-1	Normal
GATCACATCTACTGCC-1	Normal
GATCACATCTCTCGCA-1	GFAP_GBM
GATCAGTAGACGCTCC-1	GFAP_GBM
GATCAGTCACAGCTTA-1	Normal
GATCAGTCATGGGATG-1	GFAP_GBM
GATCAGTGTGTCTAAC-1	MEGF11_GBM
GATCAGTGTTCAAAGA-1	Normal
GATCAGTTCATGGCCG-1	Normal
GATCATGAGCTACTGT-1	VEGFA_GBM
GATCATGAGTATGAGT-1	Normal
GATCATGCACAATGTC-1	GFAP_GBM
GATCATGCAGAATGTA-1	VEGFA_GBM
GATCATGCAGATACCT-1	Normal
GATCATGTCGTTCATT-1	Normal
GATCCCTCATATTCGG-1	Normal
GATCCCTGTAACCAGG-1	Normal
GATCCCTGTACAGTAA-1	Normal
GATCCCTTCAAGTGGG-1	Normal
GATCCCTTCTGCCCTA-1	Normal
GATCCCTTCTTGCAGA-1	Normal
GATCGTAAGACTTCGT-1	GFAP_GBM
GATCGTAAGCGACAGT-1	GFAP_GBM
GATCGTAGTCTGTAAC-1	Normal
GATCGTAGTTTACACG-1	Normal
GATGACTAGACCAAAT-1	Normal
GATGACTAGGTTATAG-1	GFAP_GBM
GATGACTGTCGTCAGC-1	MEGF11_GBM
GATGACTTCAAAGCCT-1	Normal
GATGAGGAGGGCTTCC-1	MEGF11_GBM
GATGAGGCAGCTCGGT-1	Normal
GATGAGGGTAGATCGG-1	Normal
GATGAGGGTCAATGGG-1	VEGFA_GBM
GATGAGGGTGTCCGGT-1	VEGFA_GBM
GATGAGGGTTTGAACC-1	GFAP_GBM
GATGAGGTCACCTGTC-1	Normal
GATGATCAGGAGTCTG-1	GFAP_GBM
GATGATCAGTCGAAGC-1	Normal
GATGATCCAAATGATG-1	Normal
GATGATCCAGAGTCAG-1	Normal
GATGATCCAGCCTTCT-1	MEGF11_GBM
GATGATCCATCACCAA-1	GFAP_GBM
GATGATCGTACGTGAG-1	Normal
GATGATCGTAGCGTTT-1	MEGF11_GBM
GATGATCGTGAGTGAC-1	GFAP_GBM
GATGATCTCCTGGTCT-1	Normal
GATGATCTCTTAGCCC-1	MEGF11_GBM
GATGCTAAGCCTCAGC-1	Normal
GATGCTACATCCGCGA-1	Normal
GATGCTAGTAAGTTGA-1	MEGF11_GBM
GATGGAGAGGCACTCC-1	GFAP_GBM
GATGGAGCACGGCACT-1	Normal
GATGGAGCAGCAGAAC-1	Normal
GATGGAGGTTTCTTAC-1	VEGFA_GBM
GATGTTGAGCTAAATG-1	MEGF11_GBM
GATGTTGCACTTTATC-1	MEGF11_GBM
GATGTTGGTGCTGATT-1	Normal
GATGTTGTCGAAACAA-1	GFAP_GBM
GATGTTGTCGTCTCAC-1	MEGF11_GBM
GATTCGAAGTCGAGGT-1	Normal
GATTCGACATGACGTT-1	Normal
GATTCGATCGCGTTTC-1	VEGFA_GBM
GATTCTTAGGCCCACT-1	Normal
GATTCTTAGGGCAAGG-1	Normal
GATTCTTAGGGCAATC-1	MEGF11_GBM
GATTCTTAGTGACCTT-1	VEGFA_GBM
GATTGGTCATGCAGCC-1	Normal
GATTTCTAGATGGCGT-1	Normal
GATTTCTAGCCACAAG-1	MEGF11_GBM
GATTTCTAGTGAGTGC-1	Normal
GATTTCTCAAGATTGA-1	Normal
GATTTCTCACCGTGCA-1	MEGF11_GBM
GATTTCTCAGAGAATT-1	Normal
GCAACATAGCCTAGGA-1	MEGF11_GBM
GCAACATAGGACAAGA-1	Clone_2nd
GCAACATCAACGATCT-1	Normal
GCAACATCAGACCTGC-1	Normal
GCAACATGTAGAATGT-1	Normal
GCAACATGTCTTGAAC-1	Normal
GCAACATTCGACCAAT-1	Normal
GCAACATTCTACTATC-1	Normal
GCAACATTCTGTCGTC-1	Normal
GCAACCGAGCAGCCCT-1	MEGF11_GBM
GCAACCGAGCATCAGG-1	MEGF11_GBM
GCAACCGAGGCGACAT-1	GFAP_GBM
GCAACCGAGTTCTCTT-1	Normal
GCAACCGCACTCCACT-1	GFAP_GBM
GCAACCGGTAGGATAT-1	GFAP_GBM
GCACATAAGTCAGGGT-1	MEGF11_GBM
GCACATAGTGACTAAA-1	Normal
GCACATAGTGACTCGC-1	GFAP_GBM
GCACATAGTGGGTTGA-1	GFAP_GBM
GCACATATCGTGTTCC-1	Normal
GCACATATCTGAGGCC-1	GFAP_GBM
GCACGGTAGCCACCGT-1	Normal
GCACGGTAGCTAAACA-1	Normal
GCACGGTAGTCTGCGC-1	GFAP_GBM
GCACGGTGTCGTCGGT-1	GFAP_GBM
GCACGGTTCATTCACT-1	Normal
GCACTAAAGCGGGTTA-1	VEGFA_GBM
GCACTAACACATACTG-1	Normal
GCACTAACACGCGTCA-1	Normal
GCACTAAGTGGCTCTG-1	Normal
GCACTAAGTTACCCTC-1	GFAP_GBM
GCACTAAGTTGTCATG-1	Normal
GCACTAATCAACACCA-1	MEGF11_GBM
GCACTAATCAAGTCTG-1	Normal
GCACTAATCTATCGCC-1	Normal
GCAGCCAAGAAGCCTG-1	Normal
GCAGCCAAGCTGAGTG-1	GFAP_GBM
GCAGCCACACTGTCCT-1	MEGF11_GBM
GCAGCCATCGGACAAG-1	Normal
GCAGCTGAGACGCATG-1	Normal
GCAGCTGAGTATGGAT-1	GFAP_GBM
GCAGCTGCAACACGAG-1	Normal
GCAGCTGCAGTCTGGC-1	Normal
GCAGCTGGTCAATGGG-1	MEGF11_GBM
GCAGGCTAGACGCATG-1	Normal
GCAGGCTAGCTTCGTA-1	MEGF11_GBM
GCAGGCTCAACCACAT-1	Normal
GCAGGCTGTCAAGCCC-1	MEGF11_GBM
GCAGGCTGTGCTCCGA-1	MEGF11_GBM
GCAGGCTGTTACCCTC-1	Normal
GCAGTTAAGGGCGAGA-1	Normal
GCAGTTACACCTGTCT-1	GFAP_GBM
GCAGTTACACGTACTA-1	Normal
GCAGTTAGTGTTATCG-1	MEGF11_GBM
GCATCGGAGAGCCCAA-1	Normal
GCATCGGAGGACCCAA-1	Normal
GCATCGGCAGCAATTC-1	Normal
GCATCGGCAGCATTGT-1	Normal
GCATCGGCATGAGAAT-1	Normal
GCATCGGTCAAACCTG-1	Normal
GCATCGGTCAAGCTTG-1	Normal
GCATCGGTCCCTTGTG-1	Normal
GCATCTCAGCGCCTTG-1	MEGF11_GBM
GCATCTCCAATCAAGA-1	Normal
GCATCTCTCATGCAGT-1	Normal
GCATCTCTCCGGACGT-1	Normal
GCATGATAGAAGGCTC-1	Normal
GCATGATAGCAAGGAA-1	Normal
GCATGATGTTTGCAGT-1	Normal
GCATGATTCCAATGCA-1	GFAP_GBM
GCATTAGCATGAGTAA-1	Normal
GCATTAGGTGAACCGA-1	GFAP_GBM
GCATTAGGTTTCGCTC-1	MEGF11_GBM
GCATTAGTCCACATAG-1	MEGF11_GBM
GCATTAGTCCATTTGT-1	Normal
GCATTAGTCCGTAATG-1	Normal
GCATTAGTCTTCTGTA-1	MEGF11_GBM
GCATTAGTCTTTACAC-1	GFAP_GBM
GCCAACGAGGCTTTCA-1	Normal
GCCAACGCAGACCGCT-1	GFAP_GBM
GCCAACGGTAGTACGG-1	Normal
GCCAACGGTGTATCCA-1	VEGFA_GBM
GCCAACGGTTAGAAGT-1	VEGFA_GBM
GCCAACGGTTTAAGGA-1	Normal
GCCAACGTCGATTGAC-1	VEGFA_GBM
GCCAACGTCTAGGCAT-1	Normal
GCCAGCACAAGTTCGT-1	MEGF11_GBM
GCCAGCACAGAGGTAC-1	Normal
GCCAGCAGTATAGCTC-1	Normal
GCCAGCATCCCGAGTG-1	Normal
GCCAGCATCCGAGTGC-1	Normal
GCCAGCATCCTACAAG-1	MEGF11_GBM
GCCAGCATCGATACAC-1	Normal
GCCAGCATCGCTTACC-1	Normal
GCCAGCATCGTCAACA-1	Normal
GCCAGGTAGGATGCGT-1	MEGF11_GBM
GCCAGGTAGGATTACA-1	VEGFA_GBM
GCCAGGTCAAGGTCGA-1	Normal
GCCAGGTCAATTGGTC-1	MEGF11_GBM
GCCAGGTCACGACAAG-1	Normal
GCCAGGTCATGAAGCG-1	VEGFA_GBM
GCCAGGTTCCTAAGTG-1	Normal
GCCAGTGAGGACGCAT-1	Normal
GCCAGTGAGGCAGCTA-1	GFAP_GBM
GCCAGTGCAATGCAGG-1	MEGF11_GBM
GCCAGTGCATCAGTCA-1	Normal
GCCAGTGGTGCCTATA-1	Normal
GCCAGTGTCATTGTGG-1	Normal
GCCAGTGTCCTCAGAA-1	Normal
GCCAGTGTCTGAGAAA-1	Normal
GCCATGGAGTATGCAA-1	Normal
GCCATGGGTGCTCGTG-1	Normal
GCCATTCAGTAGCATA-1	Normal
GCCATTCAGTCTAACC-1	GFAP_GBM
GCCATTCCAATGGGTG-1	MEGF11_GBM
GCCATTCCACAAGCTT-1	MEGF11_GBM
GCCATTCCAGAACCGA-1	Normal
GCCCAGAAGAAACCAT-1	VEGFA_GBM
GCCCAGAAGGTGAGCT-1	MEGF11_GBM
GCCCAGAAGTTCGGTT-1	GFAP_GBM
GCCCAGAGTTACGCCG-1	Normal
GCCCAGAGTTGACTAC-1	GFAP_GBM
GCCCAGATCAAGGAGC-1	GFAP_GBM
GCCCAGATCGTAACTG-1	Normal
GCCCAGATCTTGCAGA-1	Normal
GCCCGAAGTCTTTCTA-1	Normal
GCCCGAATCCGTTTCG-1	Normal
GCCCGAATCGACGCGT-1	MEGF11_GBM
GCCGATGAGCGATTCT-1	Normal
GCCGATGCACCCATAA-1	Normal
GCCGATGGTAGCCAGA-1	Normal
GCCGATGTCTCGGCTT-1	Normal
GCCGATGTCTTCCTAA-1	MEGF11_GBM
GCCGTGAAGTCACTGT-1	MEGF11_GBM
GCCGTGAGTTCGGTAT-1	MEGF11_GBM
GCCGTGATCACTCTTA-1	Normal
GCCTGTTCATATCTCT-1	Normal
GCCTGTTGTGATCATC-1	Normal
GCCTGTTTCTGTGCGG-1	Clone_2nd
GCGAGAAAGTCCGTCG-1	VEGFA_GBM
GCGAGAACACAGAGAC-1	MEGF11_GBM
GCGAGAACACTAGGCC-1	MEGF11_GBM
GCGAGAACATGACACT-1	Normal
GCGAGAACATGCACTA-1	Normal
GCGAGAATCTAGTGAC-1	Normal
GCGAGAATCTTAATCC-1	Normal
GCGATCGAGCTCGTGC-1	MEGF11_GBM
GCGATCGAGTATGGCG-1	Normal
GCGATCGCACTCCGAG-1	GFAP_GBM
GCGATCGCACTGCACG-1	GFAP_GBM
GCGATCGGTATGGTAA-1	GFAP_GBM
GCGATCGGTTTACGAC-1	Normal
GCGATCGTCCCTCGAT-1	GFAP_GBM
GCGATCGTCCGTACGG-1	Normal
GCGGAAAAGACTGAGC-1	GFAP_GBM
GCGGAAATCCTTATAC-1	MEGF11_GBM
GCGGATCGTAACACGG-1	Normal
GCGGATCGTCCTGGTG-1	Normal
GCGGATCGTGATAGTA-1	GFAP_GBM
GCGTGCAAGCATTTCG-1	Normal
GCGTGCAAGGTCCTGC-1	Normal
GCGTGCACAGCGTACC-1	Normal
GCGTGCAGTAGGTAGC-1	GFAP_GBM
GCGTGCATCAAGCCTA-1	MEGF11_GBM
GCGTGCATCCTTCTTC-1	Normal
GCGTTTCAGGATTACA-1	VEGFA_GBM
GCGTTTCCATATCTCT-1	Normal
GCTACAAAGGATTTGA-1	Normal
GCTACAAAGGGACTGT-1	Normal
GCTACAAAGGTCGTAG-1	Normal
GCTACAACATGTGGCC-1	Normal
GCTACAATCAGACCTA-1	GFAP_GBM
GCTACCTGTGTGTACT-1	GFAP_GBM
GCTACCTGTTCTCGCT-1	MEGF11_GBM
GCTACCTTCCCTCATG-1	Normal
GCTACCTTCCGGCAAC-1	Normal
GCTACCTTCGACCTAA-1	Normal
GCTCAAAAGTATGGCG-1	Normal
GCTCAAACATAATCGC-1	Normal
GCTCAAATCAAACGTC-1	Normal
GCTCAAATCGCACGAC-1	Normal
GCTCAAATCGCCTATC-1	Normal
GCTCAAATCGTGACTA-1	MEGF11_GBM
GCTCAAATCTGGAAGG-1	VEGFA_GBM
GCTGAATAGTTGTAAG-1	GFAP_GBM
GCTGAATCACAAATCC-1	Normal
GCTGAATCAGCGCTTG-1	Normal
GCTGAATGTGTAGGAC-1	VEGFA_GBM
GCTGAATTCACCTCGT-1	GFAP_GBM
GCTGCAGCAGGGTCTC-1	MEGF11_GBM
GCTGCAGGTCAAGCCC-1	Normal
GCTGCAGGTGTATACC-1	Normal
GCTGCAGTCGATTTCT-1	Normal
GCTGGGTCAACTGAAA-1	Normal
GCTGGGTCAGAACATA-1	GFAP_GBM
GCTGGGTCAGAACTCT-1	Normal
GCTGGGTGTAACCCTA-1	MEGF11_GBM
GCTGGGTGTCTCTCTG-1	MEGF11_GBM
GCTGGGTGTGAGATAT-1	Normal
GCTGGGTGTGATGAAT-1	Normal
GCTGGGTTCTCTATAC-1	Normal
GCTTCACCACGCGGTT-1	GFAP_GBM
GCTTCACGTGTAAATG-1	MEGF11_GBM
GCTTCACGTTGGGCCT-1	Normal
GCTTGGGAGCATGCAG-1	Normal
GCTTGGGAGTCAGCGA-1	MEGF11_GBM
GCTTGGGAGTCCTGTA-1	Normal
GCTTGGGGTAGTCGTT-1	MEGF11_GBM
GCTTGGGGTGGCAACA-1	MEGF11_GBM
GCTTGGGTCGAACCAT-1	MEGF11_GBM
GCTTGGGTCTCGCGTT-1	VEGFA_GBM
GCTTTCGAGTGATCGG-1	GFAP_GBM
GCTTTCGCACAACATC-1	MEGF11_GBM
GCTTTCGGTCACTCTC-1	Normal
GCTTTCGTCAGAGCAG-1	Normal
GCTTTCGTCGCCGAGT-1	MEGF11_GBM
GGAACCCCAGACAAAT-1	VEGFA_GBM
GGAACCCGTAGGACCA-1	MEGF11_GBM
GGAACCCTCCATCTGC-1	GFAP_GBM
GGAACCCTCGGTCATA-1	GFAP_GBM
GGAAGTGAGCAGGCAT-1	Normal
GGAAGTGCACGCGGTT-1	Normal
GGAAGTGGTACTTGTG-1	Normal
GGAAGTGTCCTAACAG-1	Normal
GGAAGTGTCGTACACA-1	MEGF11_GBM
GGAAGTGTCTTCCGTG-1	MEGF11_GBM
GGAAGTGTCTTGGCTC-1	MEGF11_GBM
GGAATCTAGCCTCTTC-1	Normal
GGAATCTCACAGTACT-1	Normal
GGAATGGCACATGACT-1	Normal
GGAATGGCACCTCTAC-1	MEGF11_GBM
GGAATGGGTACAGAAT-1	GFAP_GBM
GGAATGGGTACGAAAT-1	MEGF11_GBM
GGAATGGGTCCAAATC-1	MEGF11_GBM
GGAATGGGTCGAATGG-1	GFAP_GBM
GGAATGGGTGCCAAGA-1	Normal
GGAATGGTCAACTTTC-1	GFAP_GBM
GGAATGGTCAGACCGC-1	VEGFA_GBM
GGAATGGTCCTCTAAT-1	Normal
GGACGTCCAAATAGCA-1	Normal
GGACGTCCACAGCTGC-1	MEGF11_GBM
GGACGTCCATGTGGCC-1	VEGFA_GBM
GGACGTCGTGCCCGTA-1	Normal
GGACGTCGTGCTGATT-1	GFAP_GBM
GGACGTCGTGCTTATG-1	MEGF11_GBM
GGACGTCGTTTCGCTC-1	Normal
GGACGTCTCCCGGTAG-1	VEGFA_GBM
GGAGAACAGACGATAT-1	MEGF11_GBM
GGAGAACCATGTTCGA-1	MEGF11_GBM
GGAGAACTCCTTCTAA-1	MEGF11_GBM
GGAGAACTCGAAGCAG-1	GFAP_GBM
GGAGATGAGTTCCGTA-1	Normal
GGAGATGTCTTGGCTC-1	Normal
GGAGCAACAAAGAGTT-1	MEGF11_GBM
GGAGCAACAGTCTCTC-1	MEGF11_GBM
GGAGCAAGTAAGCTCT-1	Normal
GGAGCAAGTACGTAGG-1	MEGF11_GBM
GGAGCAATCCATTCGC-1	Normal
GGAGGATAGAGTCACG-1	GFAP_GBM
GGAGGATAGGAGGTTC-1	MEGF11_GBM
GGAGGATAGGAGTATT-1	Normal
GGAGGATGTCACCGCA-1	MEGF11_GBM
GGAGGATTCGCCAGAC-1	Normal
GGAGGATTCTAGGAAA-1	Normal
GGATCTAAGCCTCAAT-1	Normal
GGATGTTAGGTGCTGA-1	GFAP_GBM
GGATGTTCATAGAATG-1	Normal
GGATGTTGTAACATGA-1	Normal
GGCACGTCAGGGCTTC-1	Normal
GGCACGTGTCTTTCTA-1	MEGF11_GBM
GGCACGTGTTCGGTAT-1	Normal
GGCACGTTCAAAGGAT-1	Normal
GGCACGTTCGAATGCT-1	Normal
GGCACGTTCGCTTGAA-1	Normal
GGCACGTTCTGCTGAA-1	GFAP_GBM
GGCAGTCTCACTACTT-1	Normal
GGCAGTCTCGCATGAT-1	Normal
GGCGTCAAGAATGTTG-1	Normal
GGCGTCAAGTATGGCG-1	Normal
GGCGTCAGTGAGAGGG-1	MEGF11_GBM
GGCTGTGGTATAATGG-1	Normal
GGCTGTGTCAAGAGTA-1	Normal
GGCTTGGCAGCGAGTA-1	MEGF11_GBM
GGCTTGGGTACGATGG-1	Normal
GGCTTTCCACCAGACC-1	Normal
GGCTTTCCATACTGAC-1	MEGF11_GBM
GGCTTTCGTGATATAG-1	Normal
GGCTTTCGTTCGGCGT-1	Clone_2nd
GGCTTTCTCATTCGTT-1	Normal
GGCTTTCTCTCGTGGG-1	Normal
GGGAAGTGTGATACCT-1	Normal
GGGAAGTGTTCGTGCG-1	MEGF11_GBM
GGGAAGTTCAAAGCCT-1	Normal
GGGAAGTTCCCTGGTT-1	Normal
GGGAAGTTCGCACTCT-1	MEGF11_GBM
GGGACAAAGAGGGTGG-1	MEGF11_GBM
GGGACAAAGAGGTTAT-1	VEGFA_GBM
GGGACAACACGCTTAA-1	Normal
GGGACAACACGTACAT-1	MEGF11_GBM
GGGACAAGTCACAGAG-1	Normal
GGGACAAGTCGTATGT-1	VEGFA_GBM
GGGACAAGTTTACACG-1	MEGF11_GBM
GGGACAATCAAGTCTG-1	Normal
GGGACAATCGTAGCTA-1	MEGF11_GBM
GGGACAATCTAGAACC-1	Normal
GGGACCTCACAACGTT-1	Normal
GGGACCTCACGCACCA-1	Normal
GGGACCTGTGTTCATG-1	GFAP_GBM
GGGACTCAGCGTCTGC-1	Normal
GGGACTCAGTGTCATC-1	MEGF11_GBM
GGGACTCGTCCGCAGT-1	Normal
GGGACTCGTGGACCAA-1	GFAP_GBM
GGGACTCTCCGTATGA-1	VEGFA_GBM
GGGAGATAGTCTTCCC-1	MEGF11_GBM
GGGAGATGTGCAGGAT-1	Normal
GGGAGATGTGGCACTC-1	VEGFA_GBM
GGGAGATTCTTCTGTA-1	Normal
GGGAGTAAGCATGTTC-1	Normal
GGGAGTACAGACCCGT-1	Normal
GGGAGTAGTCCGTTTC-1	GFAP_GBM
GGGAGTAGTTCACCGG-1	Clone_2nd
GGGAGTATCACATCAG-1	Normal
GGGATCCCACCGTGCA-1	Normal
GGGATCCCACGCTATA-1	Normal
GGGATCCCACTCCACT-1	Normal
GGGATCCGTTACGGAG-1	GFAP_GBM
GGGATCCTCAACTCTT-1	VEGFA_GBM
GGGATCCTCGACGCGT-1	MEGF11_GBM
GGGATCCTCGGTAACT-1	Normal
GGGATGAAGTACAGAT-1	Normal
GGGATGACACTAGGTT-1	Normal
GGGATGACAGACCAAG-1	Normal
GGGATGAGTCGGTGTC-1	MEGF11_GBM
GGGATGAGTCTCGGAC-1	MEGF11_GBM
GGGATGAGTGATTCTG-1	Normal
GGGATGAGTTCCGGTG-1	Normal
GGGCCATCAATAGTAG-1	Normal
GGGCCATGTTGGGATG-1	Normal
GGGCCATTCCGACAGC-1	Normal
GGGCCATTCCTTCACG-1	Normal
GGGCGTTAGGACTGGT-1	VEGFA_GBM
GGGCGTTCAGGCTACC-1	Normal
GGGCGTTGTGAGACGT-1	MEGF11_GBM
GGGCTACAGAGGGTAA-1	MEGF11_GBM
GGGCTACAGGTAACTA-1	VEGFA_GBM
GGGCTACGTACCGGAA-1	Normal
GGGCTACGTCGATTCA-1	Normal
GGGCTACTCCAATCCC-1	Normal
GGGCTCAAGCGAACTG-1	Normal
GGGCTCAAGGATGAGA-1	VEGFA_GBM
GGGCTCATCCATGATG-1	MEGF11_GBM
GGGTAGAAGAACAGGA-1	Normal
GGGTAGAAGAAGCGAA-1	Normal
GGGTAGACAGTCGCAC-1	MEGF11_GBM
GGGTAGAGTCGCAGTC-1	GFAP_GBM
GGGTAGATCACTACTT-1	Normal
GGGTAGATCTGAATGC-1	Normal
GGGTATTTCCTCATAT-1	VEGFA_GBM
GGGTATTTCTTACGGA-1	Normal
GGGTCACAGTGTCATC-1	Normal
GGGTCACCATATTCGG-1	Normal
GGGTCTGAGGACAGCT-1	Normal
GGGTCTGCAGATACCT-1	GFAP_GBM
GGGTCTGCATGCCGAC-1	Normal
GGGTCTGGTATCACCA-1	MEGF11_GBM
GGGTCTGGTTGCATGT-1	Normal
GGGTCTGTCCTCACGT-1	Normal
GGGTGAAAGGGTTGCA-1	GFAP_GBM
GGGTGAAGTATCGATC-1	Normal
GGGTGAATCCAAACCA-1	Normal
GGGTGAATCCAGGACC-1	Normal
GGGTGTCCAGCGCGTT-1	MEGF11_GBM
GGGTGTCGTGGACCTC-1	Normal
GGGTGTCGTTGGTAGG-1	MEGF11_GBM
GGGTTATAGGCAGGGA-1	Normal
GGGTTATAGTGACACG-1	MEGF11_GBM
GGGTTATCAAAGTGTA-1	MEGF11_GBM
GGGTTATCAATACAGA-1	Normal
GGGTTATCAGCGAGTA-1	Normal
GGGTTATCAGCTCCTT-1	VEGFA_GBM
GGGTTATTCAGGAGAC-1	MEGF11_GBM
GGGTTATTCCGCTGTT-1	VEGFA_GBM
GGGTTTAAGACGCATG-1	GFAP_GBM
GGGTTTAAGCAGGCTA-1	Normal
GGGTTTAAGGTTGACG-1	Normal
GGGTTTACACGCAAAG-1	Normal
GGGTTTAGTCTTGTCC-1	GFAP_GBM
GGTAACTCAGAGGAAA-1	GFAP_GBM
GGTAACTGTCACTGAT-1	Normal
GGTAATCAGGATATAC-1	Normal
GGTAATCGTATCCTTT-1	Normal
GGTAATCGTCAACGCC-1	VEGFA_GBM
GGTAATCTCCCAAGCG-1	Normal
GGTAATCTCCTACCAC-1	MEGF11_GBM
GGTAATCTCGGAAGGT-1	Normal
GGTAGAGCACCCTGTT-1	Normal
GGTAGAGGTGGATCAG-1	MEGF11_GBM
GGTAGAGGTTCCACGG-1	Normal
GGTAGAGTCCTCACGT-1	GFAP_GBM
GGTAGAGTCTCATAGG-1	GFAP_GBM
GGTCACGAGGATGGCT-1	MEGF11_GBM
GGTCACGAGTACTCGT-1	Normal
GGTCACGCAATAGTCC-1	VEGFA_GBM
GGTCACGCACAAGTTC-1	Normal
GGTCACGCAGTTGGTT-1	Normal
GGTCTGGCACTGGAAG-1	MEGF11_GBM
GGTCTGGCAGTCAGCC-1	Normal
GGTCTGGCATGGCCAC-1	Normal
GGTCTGGTCCCAAGCG-1	Normal
GGTCTGGTCGGAATGG-1	MEGF11_GBM
GGTCTGGTCGTACACA-1	VEGFA_GBM
GGTCTGGTCTAGCATG-1	Normal
GGTCTGGTCTCGTTTA-1	GFAP_GBM
GGTGAAGAGAAGTCTA-1	VEGFA_GBM
GGTGAAGAGGCATTTC-1	MEGF11_GBM
GGTGAAGCAGGACATG-1	Normal
GGTGAAGGTGGCTACC-1	Normal
GGTGATTCAGCAGTCC-1	MEGF11_GBM
GGTGATTGTGGGTATG-1	Normal
GGTGATTGTGTATTGC-1	Normal
GGTGATTTCAACCTCC-1	Normal
GGTGGCTCAGGAACCA-1	Normal
GGTGGCTCAGGTAGTG-1	Normal
GGTGGCTCATGTGGCC-1	Normal
GGTGGCTGTCCTCAGG-1	MEGF11_GBM
GGTGTCGAGACCATGG-1	Normal
GGTGTCGAGGACAGTC-1	Normal
GGTGTCGCAGCGAACA-1	MEGF11_GBM
GGTGTCGCAGGCTCTG-1	Normal
GGTGTCGTCCCTTCCC-1	Normal
GGTGTTAAGTGAGCCA-1	Normal
GGTGTTAGTAGGATAT-1	MEGF11_GBM
GGTTAACCAGAACATA-1	GFAP_GBM
GGTTAACGTTAGCTAC-1	Normal
GGTTAACTCTAAACGC-1	VEGFA_GBM
GGTTCTCCACATTGTG-1	GFAP_GBM
GGTTCTCCAGCTGCCA-1	Normal
GGTTCTCGTGTTCAGT-1	Normal
GGTTGTAAGGTAGTCG-1	GFAP_GBM
GGTTGTATCTGGTGCG-1	VEGFA_GBM
GTAACACAGATGTTCC-1	Normal
GTAACACTCGGACAAG-1	MEGF11_GBM
GTAACACTCTTCTGTA-1	Normal
GTAACCAGTATCCTTT-1	MEGF11_GBM
GTAACCATCAGAGTTC-1	Normal
GTAACCATCGCTACGG-1	MEGF11_GBM
GTAAGTCGTTATAGAG-1	Normal
GTAAGTCTCCATTTAC-1	Normal
GTAATCGCAGAAATCA-1	GFAP_GBM
GTAATCGCATCGGCCA-1	Normal
GTAATCGCATCTAGAC-1	GFAP_GBM
GTAATCGCATGTTACG-1	Normal
GTAATCGGTGAGTTTC-1	MEGF11_GBM
GTAATCGGTTGCACGC-1	MEGF11_GBM
GTAATCGTCAGCATTG-1	Normal
GTAATGCAGAATGTTG-1	Normal
GTAATGCCAAATCGTC-1	MEGF11_GBM
GTAATGCCAGTCCCGA-1	GFAP_GBM
GTAATGCGTCCTTAAG-1	Normal
GTAATGCTCACGTAGT-1	Normal
GTAATGCTCCATCGTC-1	Normal
GTACAACCACCAGTAT-1	Normal
GTACAACCAGTCACGC-1	Normal
GTACAACGTAGCGAGT-1	Normal
GTACAGTAGACGAGCT-1	MEGF11_GBM
GTACAGTTCCATACTT-1	Normal
GTAGAAAAGATGGTCG-1	Normal
GTAGAAAGTAACATCC-1	Normal
GTAGAAAGTGCCTAAT-1	MEGF11_GBM
GTAGAAATCACGATCA-1	GFAP_GBM
GTAGAGGAGGGCAATC-1	Normal
GTAGAGGCACCCTTGT-1	Normal
GTAGAGGGTACAACGG-1	GFAP_GBM
GTAGAGGGTTCCAGGC-1	Normal
GTAGAGGTCCGATCTC-1	MEGF11_GBM
GTAGATCAGGGCCCTT-1	MEGF11_GBM
GTAGATCCAAGGCTTT-1	MEGF11_GBM
GTAGATCCACGTACAT-1	Normal
GTAGATCGTGTCTTGA-1	Normal
GTAGATCGTTACAGCT-1	Normal
GTAGATCTCGGTCACG-1	Normal
GTAGCTACAAGCGATG-1	Normal
GTAGGAGGTTAAACCC-1	VEGFA_GBM
GTAGGAGTCAGTCAGT-1	Normal
GTAGGTTAGCTAGAGC-1	MEGF11_GBM
GTAGGTTGTAAGACCG-1	Normal
GTAGGTTTCTCAATCT-1	Clone_2nd
GTAGTACCACGGTGCT-1	Normal
GTAGTACGTACGTAGG-1	MEGF11_GBM
GTAGTACGTGATCATC-1	Normal
GTAGTACTCACAGTGT-1	Normal
GTAGTACTCATACGGT-1	Clone_2nd
GTAGTACTCTATACTC-1	Normal
GTATTGGAGAGCTGCA-1	Normal
GTATTGGTCGGATACT-1	Normal
GTATTTCAGCGCCGTT-1	MEGF11_GBM
GTATTTCGTCGATTTG-1	MEGF11_GBM
GTATTTCTCAACTGGT-1	Normal
GTATTTCTCAGCGTCG-1	MEGF11_GBM
GTCAAACCACAATGAA-1	Normal
GTCAAACGTCCTTGTC-1	Normal
GTCAAACGTTGGCTAT-1	Normal
GTCAAACTCCCTCGAT-1	Normal
GTCAAACTCGGCTGGT-1	MEGF11_GBM
GTCAAGTGTATTGGCT-1	Normal
GTCACGGAGAGTTGAT-1	MEGF11_GBM
GTCACGGGTAGTTACC-1	VEGFA_GBM
GTCACGGGTGGATTTC-1	MEGF11_GBM
GTCACTCAGACATAGT-1	Normal
GTCACTCAGGTCGACA-1	Normal
GTCACTCCAGTGTGCC-1	Normal
GTCACTCTCAGGAAGC-1	MEGF11_GBM
GTCACTCTCGAGCCAC-1	MEGF11_GBM
GTCAGCGAGGAAGTCC-1	Normal
GTCAGCGAGGGCCAAT-1	Normal
GTCAGCGGTTATTCCT-1	Normal
GTCAGCGTCATGAGTC-1	Normal
GTCAGCGTCCTACCAC-1	Normal
GTCAGCGTCCTACGAA-1	Clone_2nd
GTCAGCGTCGGACTTA-1	Normal
GTCATCCAGATAACGT-1	VEGFA_GBM
GTCATCCAGGAAAGTG-1	MEGF11_GBM
GTCATCCCATGACGAG-1	GFAP_GBM
GTCATCCTCGAGTGGA-1	Normal
GTCATGAGTGCTGATT-1	Normal
GTCATGAGTGGACAGT-1	Normal
GTCATTTAGAGGCGGA-1	GFAP_GBM
GTCATTTAGAGTCAAT-1	Normal
GTCATTTAGGTGCTTT-1	Normal
GTCATTTCACCTGCTT-1	Normal
GTCATTTCATTGCAAC-1	Normal
GTCATTTGTTCGGCTG-1	Normal
GTCATTTTCTACGGGC-1	Normal
GTCCACTGTCCTGTTC-1	Normal
GTCCACTTCCGAACGC-1	Normal
GTCCCATGTGGCCACT-1	MEGF11_GBM
GTCCCATGTTGCAAGG-1	Normal
GTCCTCAAGACTTCAC-1	Normal
GTCCTCACAGACGCTC-1	Normal
GTCCTCAGTGAATGAT-1	Clone_2nd
GTCGAATCACAGCATT-1	Normal
GTCGAATCATGTTTGG-1	Normal
GTCGAATGTAGTACGG-1	Normal
GTCGCGACACTTCATT-1	Normal
GTCGCGACATCACCAA-1	Normal
GTCGTAAAGACTCATC-1	Normal
GTCGTAAAGCTTAGTC-1	Normal
GTCGTAACACGCCAGT-1	Normal
GTCGTAAGTAAGACCG-1	Normal
GTCGTAAGTCCCGTGA-1	GFAP_GBM
GTCGTAAGTCTCACGG-1	GFAP_GBM
GTCGTAAGTGTAAATG-1	Normal
GTCGTAAGTTTGGGTT-1	MEGF11_GBM
GTCGTTCAGTCTCTGA-1	Normal
GTCGTTCCATATCTGG-1	Normal
GTCGTTCGTTTCTTAC-1	Normal
GTCTACCGTAATTGGA-1	Normal
GTCTACCGTTATCTGG-1	Normal
GTCTACCTCTGACCCT-1	Normal
GTCTAGAAGTGACCTT-1	GFAP_GBM
GTCTAGAAGTTACGTC-1	Normal
GTCTAGACATTATGCG-1	VEGFA_GBM
GTCTAGATCTTACGGA-1	GFAP_GBM
GTCTCACAGCTCCACG-1	GFAP_GBM
GTCTCACAGGGTCAAC-1	Normal
GTCTCACAGTGATGGC-1	Normal
GTCTGTCAGGGATCGT-1	Normal
GTCTGTCAGTAAGACT-1	Normal
GTCTGTCGTAAGTAGT-1	Normal
GTCTGTCGTAGCTGCC-1	Normal
GTCTGTCGTGTCGATT-1	Normal
GTCTGTCGTGTTCGAT-1	GFAP_GBM
GTCTGTCTCGCTTGAA-1	GFAP_GBM
GTCTTTAAGATGAATC-1	Normal
GTCTTTACACCTGCGA-1	Normal
GTCTTTACAGCAGTAG-1	MEGF11_GBM
GTCTTTAGTCCTCCAT-1	GFAP_GBM
GTCTTTAGTTCGGGTC-1	Normal
GTCTTTATCATGAGTC-1	Normal
GTGACGCAGCCATTCA-1	Normal
GTGACGCCAAGGGCAT-1	MEGF11_GBM
GTGACGCCACCCAATA-1	MEGF11_GBM
GTGACGCGTTCAACGT-1	Normal
GTGAGCCAGCGTGAGT-1	GFAP_GBM
GTGAGCCAGCTTGTTG-1	MEGF11_GBM
GTGAGCCCAACTTCTT-1	Normal
GTGAGCCCAATTGGTC-1	Normal
GTGAGCCCATCTGCGG-1	MEGF11_GBM
GTGAGCCGTCAACACT-1	Normal
GTGAGCCGTCCACGCA-1	Normal
GTGAGGACAATCCTTT-1	Normal
GTGAGTTGTAGCTGAG-1	GFAP_GBM
GTGAGTTTCATCGCAA-1	MEGF11_GBM
GTGATGTCACTGATTG-1	Normal
GTGATGTCATCTTAGG-1	Normal
GTGATGTCATGGGATG-1	Normal
GTGATGTGTTTCCATT-1	Normal
GTGATGTTCCACACAA-1	Normal
GTGATGTTCGATACTG-1	Normal
GTGCACGCAACCACAT-1	Normal
GTGCACGCATGACACT-1	MEGF11_GBM
GTGCACGGTCACAGTT-1	Normal
GTGCACGGTCAGGTAG-1	VEGFA_GBM
GTGCACGGTGGACTAG-1	Normal
GTGCACGGTTTCAGAC-1	Normal
GTGCACGTCAAGGAGC-1	MEGF11_GBM
GTGCACGTCACCTACC-1	Normal
GTGCACGTCTGCCTCA-1	Normal
GTGCAGCAGCGTCTCG-1	GFAP_GBM
GTGCAGCAGCTCATAC-1	VEGFA_GBM
GTGCAGCAGGAGAATG-1	GFAP_GBM
GTGCAGCCAAACCATC-1	MEGF11_GBM
GTGCAGCCACAAATAG-1	Normal
GTGCAGCCACCCAACG-1	Normal
GTGCAGCTCCCGGTAG-1	Normal
GTGCAGCTCGGACAAG-1	Normal
GTGCAGCTCTTTCAGT-1	Normal
GTGCGTGAGGATGGCT-1	Normal
GTGCGTGGTTTCGACA-1	Normal
GTGCGTGTCAAGTGTC-1	Normal
GTGCGTGTCACGGGCT-1	GFAP_GBM
GTGCTGGAGAATAGTC-1	MEGF11_GBM
GTGCTGGAGCAATAGT-1	Normal
GTGCTGGAGGACATCG-1	MEGF11_GBM
GTGCTGGCAAGATGTA-1	Normal
GTGCTGGCATGGTACT-1	GFAP_GBM
GTGCTGGGTGAGCTCC-1	Normal
GTGCTGGTCTACAGGT-1	Normal
GTGCTGGTCTCACCCA-1	GFAP_GBM
GTGCTTCAGTTGGGAC-1	MEGF11_GBM
GTGCTTCCATCTCCCA-1	MEGF11_GBM
GTGCTTCGTCCGGACT-1	VEGFA_GBM
GTGGAAGCAATAGGGC-1	Normal
GTGGAAGCAGACCAGA-1	MEGF11_GBM
GTGGAAGGTGCATGTT-1	MEGF11_GBM
GTGGAAGGTTGGGTAG-1	MEGF11_GBM
GTGGAGAAGCTGCGAA-1	Normal
GTGGAGAGTCGGCTAC-1	MEGF11_GBM
GTGGCGTAGCACACCC-1	GFAP_GBM
GTGGCGTAGCTGACCC-1	Normal
GTGGCGTCACACGGTC-1	Normal
GTGGCGTCACGGTGTC-1	MEGF11_GBM
GTGGCGTCATAGTCAC-1	MEGF11_GBM
GTGGCGTGTTTACACG-1	Normal
GTGGCGTTCCGAACGC-1	Normal
GTGGCGTTCGGAGTGA-1	Normal
GTGGCGTTCTCTGCCA-1	Normal
GTGGGAAAGATGTTGA-1	Normal
GTGGGAAAGATTGACA-1	GFAP_GBM
GTGGTTACAACCTATG-1	MEGF11_GBM
GTGGTTACAGGTTACT-1	Normal
GTGGTTACATGATCTG-1	VEGFA_GBM
GTGGTTAGTAGGGAGG-1	Normal
GTGGTTAGTGATTCAC-1	Normal
GTGGTTATCTACCCAC-1	Normal
GTGTAACAGGGATCGT-1	Clone_2nd
GTGTAACGTACAGTAA-1	GFAP_GBM
GTGTAACGTTATGACC-1	Normal
GTGTAACGTTTGTGGT-1	MEGF11_GBM
GTGTAACTCCGAGGCT-1	VEGFA_GBM
GTGTAACTCTGTAACG-1	Normal
GTGTCCTAGCGCTGAA-1	Normal
GTGTCCTAGGGCAGTT-1	Normal
GTGTCCTAGTGTACCT-1	Normal
GTGTCCTCACCAGCTG-1	GFAP_GBM
GTGTCCTGTGGCCCAT-1	MEGF11_GBM
GTGTCCTGTGGTCAAG-1	Normal
GTGTCCTTCAGTCAGT-1	Normal
GTGTCCTTCCATGAGT-1	Normal
GTGTCCTTCCTACGAA-1	Normal
GTGTCCTTCTTCCAGC-1	Normal
GTGTGATCAAACCACT-1	Normal
GTGTGATCAGGACATG-1	Normal
GTGTGATGTCCGTACG-1	MEGF11_GBM
GTGTGATTCAAGCTTG-1	Normal
GTGTGATTCGTTCAGA-1	Normal
GTGTGATTCGTTCTGC-1	MEGF11_GBM
GTGTGATTCTCGACGG-1	Normal
GTGTGATTCTGCGTCT-1	VEGFA_GBM
GTGTGGCAGGATGGCT-1	Normal
GTGTGGCCACGCACCA-1	Normal
GTGTGGCGTATCGCGC-1	Normal
GTGTGGCGTGGAGGTT-1	Normal
GTGTTAGAGTTGTACC-1	Normal
GTGTTAGCAACAGAGC-1	MEGF11_GBM
GTGTTCCAGCCGATTT-1	Normal
GTGTTCCAGCCTCAAT-1	VEGFA_GBM
GTGTTCCCAACCCTAA-1	VEGFA_GBM
GTGTTCCTCTTTCGAT-1	VEGFA_GBM
GTTACAGAGGATGAGA-1	MEGF11_GBM
GTTACAGCAAGACGAC-1	Normal
GTTACAGCAATACGCT-1	Normal
GTTACAGTCCCAAGTA-1	MEGF11_GBM
GTTACAGTCTTGGTGA-1	Normal
GTTACCCCAGATCATC-1	Normal
GTTACCCCATAATCCG-1	Normal
GTTACCCTCTACTTCA-1	Normal
GTTACCCTCTTCGACC-1	VEGFA_GBM
GTTACGAAGAGTCAGC-1	Normal
GTTACGAAGGTAGACC-1	Normal
GTTACGATCGTGTCAA-1	Normal
GTTAGACCATCGAGCC-1	Normal
GTTAGACGTAACACCT-1	Normal
GTTAGTGCAACCCGCA-1	MEGF11_GBM
GTTAGTGCAGTTGAAA-1	Normal
GTTAGTGGTCGAGCTC-1	Normal
GTTAGTGTCATTTACC-1	MEGF11_GBM
GTTAGTGTCCATAGAC-1	VEGFA_GBM
GTTATGGAGATTACCC-1	Normal
GTTATGGCATCGTTCC-1	MEGF11_GBM
GTTATGGGTTGTACGT-1	GFAP_GBM
GTTCATTAGACCTGGA-1	Normal
GTTCATTAGTATGACA-1	GFAP_GBM
GTTCATTCACATACTG-1	Normal
GTTCATTCAGCTGTGC-1	Normal
GTTCATTCATGGAACG-1	Normal
GTTCATTGTCCGAAGA-1	GFAP_GBM
GTTCCGTAGGTTCTAC-1	Normal
GTTCCGTCAAGTCGTT-1	GFAP_GBM
GTTCCGTGTCGCTGCA-1	Normal
GTTCCGTTCATTGCGA-1	MEGF11_GBM
GTTCCGTTCTGTGCTC-1	Normal
GTTCCGTTCTGTTCAT-1	Normal
GTTCGCTAGTATGAGT-1	Normal
GTTCGCTCAGACTCTA-1	Normal
GTTCTATAGACTTGTC-1	Normal
GTTCTATAGTGGATAT-1	Normal
GTTCTATGTACAGTCT-1	MEGF11_GBM
GTTCTATGTAGAGATT-1	Normal
GTTCTATTCAGGTAAA-1	Normal
GTTGAACAGCGCGTTC-1	GFAP_GBM
GTTGAACCATCAGCAT-1	Normal
GTTGAACGTTGCCATA-1	Normal
GTTGAACGTTTGTTCT-1	Normal
GTTGAACTCCATAGAC-1	MEGF11_GBM
GTTGAACTCGCCTCTA-1	Normal
GTTGAACTCGTCTACC-1	Normal
GTTGAACTCTAGGCAT-1	Normal
GTTGCGGAGAATAACC-1	Normal
GTTGCGGAGAATTCAG-1	GFAP_GBM
GTTGCGGGTTCGATTG-1	Normal
GTTGCTCCACAAGGTG-1	Normal
GTTGCTCGTCCTGGTG-1	Normal
GTTGCTCGTGCGTCGT-1	MEGF11_GBM
GTTGCTCGTGGTAACG-1	Normal
GTTGCTCGTTGTATGC-1	Normal
GTTGCTCTCAAGTTGC-1	Normal
GTTGCTCTCTCGACCT-1	VEGFA_GBM
GTTGTAGCAACAAGAT-1	MEGF11_GBM
GTTGTAGCACTTTAGG-1	GFAP_GBM
GTTGTAGGTAAGGCCA-1	Normal
GTTGTAGGTAGGTACG-1	Normal
GTTGTAGTCATTCGTT-1	Normal
GTTGTCCCAACGATTC-1	Normal
GTTGTCCGTGCCTTTC-1	Normal
GTTGTCCGTGGTTCTA-1	Normal
GTTGTCCTCCTCTGCA-1	MEGF11_GBM
GTTGTGACAAATGATG-1	GFAP_GBM
GTTGTGAGTAGTGTGG-1	GFAP_GBM
GTTGTGAGTATCAGCT-1	VEGFA_GBM
GTTGTGAGTCGTGATT-1	Normal
GTTGTGAGTTCCGGTG-1	MEGF11_GBM
GTTGTGATCGGTCTAA-1	GFAP_GBM
GTTTACTAGAAACTAC-1	Normal
GTTTACTCAACTTCTT-1	Normal
GTTTGGAAGATAACGT-1	MEGF11_GBM
GTTTGGACATTGACCA-1	Normal
GTTTGGAGTAGCCCTG-1	Normal
GTTTGGAGTCATATGC-1	GFAP_GBM
GTTTGGAGTGGACAGT-1	Normal
GTTTGGATCTCGCAGG-1	MEGF11_GBM
GTTTGGATCTGGCCGA-1	Normal
TAACACGCAACGGCCT-1	Normal
TAACACGCAGTAGAGC-1	Normal
TAACACGGTGAATGAT-1	Normal
TAACACGGTGCTGATT-1	Normal
TAACCAGCAGGCGAAT-1	Normal
TAACCAGGTATCCTCC-1	VEGFA_GBM
TAACCAGTCGTAGTCA-1	MEGF11_GBM
TAACCAGTCTCCGATC-1	MEGF11_GBM
TAACGACCAATATCCG-1	MEGF11_GBM
TAACGACCAGATTTCG-1	VEGFA_GBM
TAACGACCAGCCGTTG-1	Normal
TAACGACGTACGACAG-1	Normal
TAACGACGTATCGATC-1	MEGF11_GBM
TAACGACGTCACAATC-1	Normal
TAACGACTCTTAGTTC-1	Normal
TAACTTCAGAAACTAC-1	Normal
TAACTTCAGGTTTACC-1	VEGFA_GBM
TAACTTCCAGGTGTTT-1	GFAP_GBM
TAACTTCGTCCAATCA-1	Normal
TAACTTCGTGAATATG-1	Normal
TAACTTCGTGATGAAT-1	VEGFA_GBM
TAAGCACCATTGCCTC-1	MEGF11_GBM
TAAGCACGTCAGGTGA-1	MEGF11_GBM
TAAGCACTCCATAGAC-1	Normal
TAAGCCACATCCTTCG-1	Normal
TAAGCCACATGTTACG-1	Normal
TAAGCCAGTCGAGCAA-1	MEGF11_GBM
TAAGCCATCGGTCTGG-1	Normal
TAAGCGTAGATCGACG-1	Normal
TAAGCGTAGCAACTCT-1	Normal
TAAGCGTGTCCATCTC-1	Normal
TAAGCGTGTTTGAAAG-1	Normal
TAAGTCGAGCTCCCTT-1	Normal
TAAGTCGCATGTTCGA-1	MEGF11_GBM
TAATCTCAGGCATCTT-1	GFAP_GBM
TAATCTCCAAAGTGTA-1	VEGFA_GBM
TAATTCCAGAATTGCA-1	MEGF11_GBM
TAATTCCAGACATAAC-1	MEGF11_GBM
TAATTCCGTTAGGACG-1	GFAP_GBM
TAATTCCTCTGTCGTC-1	GFAP_GBM
TACAACGCAAGCACAG-1	MEGF11_GBM
TACAACGCACTGGATT-1	Normal
TACAACGGTATAGCTC-1	GFAP_GBM
TACAACGGTTAGCTAC-1	Normal
TACAACGTCCATATGG-1	Clone_2nd
TACACCCAGATGTTCC-1	Normal
TACACCCAGCTTCTAG-1	VEGFA_GBM
TACACCCAGGATTTAG-1	Normal
TACACCCGTCTGCATA-1	Normal
TACACCCTCAGCTGAT-1	Normal
TACAGGTAGGTAAGAG-1	MEGF11_GBM
TACAGGTCAACTGAAA-1	MEGF11_GBM
TACAGGTGTCCATCTC-1	Normal
TACAGGTTCCATAGAC-1	GFAP_GBM
TACAGGTTCGACTCCT-1	Normal
TACAGGTTCGATAACC-1	Normal
TACAGGTTCTCGTTTA-1	Normal
TACAGGTTCTTGCAAG-1	Normal
TACATTCCAACGACTT-1	Normal
TACATTCCAAGTGCAG-1	Normal
TACATTCGTATCGTAC-1	Normal
TACATTCGTGGTCTAT-1	MEGF11_GBM
TACATTCTCAGCTGTA-1	Normal
TACCCACAGAGGATGA-1	MEGF11_GBM
TACCCACCAATAGTGA-1	Normal
TACCCACGTCAGCTTA-1	Normal
TACCCGTAGGGACAGG-1	MEGF11_GBM
TACCCGTCAGGCGATA-1	GFAP_GBM
TACCCGTCAGTCAGCC-1	Normal
TACCCGTGTTGTTGCA-1	Normal
TACCGAAAGCGTGTTT-1	MEGF11_GBM
TACCGAACACCAGCCA-1	Normal
TACCGAACAGCGTGCT-1	Normal
TACCGAATCACCATCC-1	Normal
TACCGAATCCATTGTT-1	Normal
TACCGAATCTGTAACG-1	Normal
TACCGGGCACACCGAC-1	Normal
TACCGGGGTTGTCTAG-1	Normal
TACCGGGTCTCATTAC-1	Normal
TACCTCGGTGTCACAT-1	GFAP_GBM
TACCTCGTCATCTACT-1	MEGF11_GBM
TACCTGCAGACCGCCT-1	Normal
TACCTGCCACTGAATC-1	Normal
TACCTGCGTAGGCTGA-1	Normal
TACCTGCGTATTTCGG-1	GFAP_GBM
TACGCTCCACCCTGAG-1	Normal
TACGCTCTCACACCGG-1	Normal
TACGCTCTCACTCACC-1	Normal
TACGGGCAGCTAATGA-1	Normal
TACGGGCCACCATAAC-1	Normal
TACGGGCCACCGGAAA-1	Normal
TACGGGCCAGTGCCTG-1	Normal
TACGGTAAGATGTAGT-1	GFAP_GBM
TACGGTAGTGTGAATA-1	Normal
TACGGTAGTTCGAAGG-1	Normal
TACGGTATCTCGCGTT-1	Normal
TACGTCCCAGCCGGTT-1	Normal
TACGTCCCATCGGTTA-1	Normal
TACGTCCGTGGTAATA-1	VEGFA_GBM
TACGTCCTCAACGAGG-1	Normal
TACGTCCTCAGCAGAG-1	Normal
TACGTCCTCTTTGGAG-1	Normal
TACTGCCAGACGGAAA-1	MEGF11_GBM
TACTGCCCACTGCACG-1	Normal
TACTGCCCACTTCTCG-1	MEGF11_GBM
TACTGCCGTTCAGTAC-1	Clone_2nd
TACTGCCTCGATGCAT-1	Normal
TACTTACAGGGCTAAC-1	GFAP_GBM
TACTTACGTCGAAACG-1	Normal
TACTTACGTGCAGGAT-1	Normal
TACTTACGTTCGGTAT-1	MEGF11_GBM
TACTTACTCGAACACT-1	Normal
TACTTACTCGTGGTAT-1	VEGFA_GBM
TACTTCACAGCTCTGG-1	MEGF11_GBM
TACTTCAGTGCCCTTT-1	Normal
TACTTCAGTGCCGTTG-1	Normal
TACTTCAGTGGCCTCA-1	Normal
TACTTCATCTCGGCTT-1	Normal
TACTTCATCTGGGATT-1	Normal
TACTTGTGTCCAGCAC-1	MEGF11_GBM
TAGACCACAACTCGAT-1	MEGF11_GBM
TAGACCAGTCCAGAAG-1	GFAP_GBM
TAGACTGCAAGTGACG-1	VEGFA_GBM
TAGACTGCAGCAGTAG-1	Normal
TAGACTGGTGTTACAC-1	MEGF11_GBM
TAGAGTCCAACCCTAA-1	MEGF11_GBM
TAGAGTCGTCGTTTCC-1	Normal
TAGATCGAGAGTTGCG-1	Normal
TAGATCGAGTTCGGTT-1	Normal
TAGATCGCAAGGAGTC-1	Normal
TAGATCGGTCTGCATA-1	Normal
TAGATCGGTGTATTCG-1	Normal
TAGATCGTCGCCCAGA-1	GFAP_GBM
TAGCACAAGCAGCCCT-1	Normal
TAGCACAAGGCTCACC-1	Normal
TAGCACAAGTATGGCG-1	Normal
TAGGAGGAGATGATTG-1	GFAP_GBM
TAGGAGGAGTGGAAAG-1	VEGFA_GBM
TAGGAGGCATTAGGCT-1	Normal
TAGGGTTCACCACTGG-1	Normal
TAGGGTTCACTTGAAC-1	Normal
TAGGGTTGTAGCTTGT-1	MEGF11_GBM
TAGGGTTGTGAGAGGG-1	Normal
TAGGGTTGTGGGCTTC-1	Normal
TAGGGTTGTGTTTCTT-1	MEGF11_GBM
TAGGGTTTCATGAGGG-1	GFAP_GBM
TAGGGTTTCCTAACAG-1	MEGF11_GBM
TAGGTACAGGTACAGC-1	Normal
TAGGTACCACGAGAAC-1	Normal
TAGGTACCATATAGCC-1	Normal
TAGGTACGTCTTAGTG-1	Normal
TAGGTTGCAGACCAGA-1	Normal
TAGGTTGGTGACAACG-1	Normal
TAGGTTGTCATGAAAG-1	Normal
TAGTGCAAGTTGGACG-1	GFAP_GBM
TAGTGCACACAAGTTC-1	Normal
TAGTGCAGTACTGCGC-1	Normal
TAGTGCAGTATATGGA-1	Normal
TAGTGCAGTCCAGTTA-1	Normal
TATACCTCACGCCACA-1	GFAP_GBM
TATACCTCAGTGGTGA-1	Normal
TATACCTCATGCCGCA-1	Normal
TATACCTGTCTATGAC-1	Normal
TATACCTTCGAAATCC-1	Normal
TATACCTTCTAACACG-1	Normal
TATATCCAGCACAAAT-1	GFAP_GBM
TATATCCCAATCTGCA-1	Clone_2nd
TATATCCCATAGCTGT-1	Normal
TATATCCTCTACCCAC-1	GFAP_GBM
TATATCCTCTCGAACA-1	GFAP_GBM
TATCAGGCAATACGCT-1	MEGF11_GBM
TATCAGGCACTACGGC-1	Normal
TATCAGGCAGAGATTA-1	MEGF11_GBM
TATCAGGCAGCGGATA-1	Normal
TATCAGGCAGTATACC-1	Normal
TATCAGGGTAGATCCT-1	GFAP_GBM
TATCAGGGTGTCCCTT-1	VEGFA_GBM
TATCAGGGTGTTTACG-1	Normal
TATCAGGTCATTATCC-1	GFAP_GBM
TATCAGGTCCACAGCG-1	MEGF11_GBM
TATCAGGTCCATCCGT-1	Normal
TATCAGGTCGAGTGGA-1	Normal
TATCCTAAGCTGAAAT-1	Normal
TATCCTAAGCTTAGTC-1	MEGF11_GBM
TATCCTAAGTCCTGCG-1	Normal
TATCCTACACCTCTAC-1	MEGF11_GBM
TATCCTACACTGCGAC-1	Normal
TATCCTACATACAGAA-1	Normal
TATCCTAGTATTAAGG-1	GFAP_GBM
TATCGCCAGCTCTGTA-1	Normal
TATCGCCCATACACCA-1	MEGF11_GBM
TATCGCCGTAATGTGA-1	Normal
TATCGCCGTCGACTTA-1	VEGFA_GBM
TATCGCCGTTCAGGTT-1	Normal
TATCTGTAGAGACAAG-1	MEGF11_GBM
TATCTGTCAACACAAA-1	VEGFA_GBM
TATCTGTTCTTAATCC-1	Normal
TATCTTGAGCCATTTG-1	Normal
TATCTTGCAAGATTGA-1	Normal
TATCTTGCATCGAAGG-1	GFAP_GBM
TATCTTGGTAGCTTTG-1	VEGFA_GBM
TATCTTGGTGCGTGCT-1	MEGF11_GBM
TATCTTGGTTATTCTC-1	Normal
TATCTTGTCCAACCGG-1	Normal
TATCTTGTCGCCAGTG-1	VEGFA_GBM
TATGTTCAGCGATGAC-1	Normal
TATGTTCAGGGAGAAT-1	Normal
TATGTTCAGGTGCTGA-1	GFAP_GBM
TATGTTCCACGGCCAT-1	MEGF11_GBM
TATGTTCCATAAGCAA-1	Normal
TATGTTCGTACCCGCA-1	MEGF11_GBM
TATGTTCGTCGATTCA-1	Normal
TATGTTCTCCTTCTGG-1	VEGFA_GBM
TATTCCAAGAGGTTAT-1	Normal
TATTCCACAACCGCTG-1	MEGF11_GBM
TATTCCAGTATGCTTG-1	VEGFA_GBM
TATTCCAGTTCACCGG-1	Normal
TATTCCATCCGCACGA-1	Normal
TATTGCTAGGTGCTAG-1	VEGFA_GBM
TATTGCTCAACGTTAC-1	Normal
TATTGCTCACGCCAGT-1	MEGF11_GBM
TATTGCTTCAAGTAAG-1	Normal
TATTGCTTCTAGTCAG-1	Normal
TATTGGGAGACGAGCT-1	MEGF11_GBM
TATTGGGCACTACTTT-1	Normal
TATTTCGGTGATACAA-1	Normal
TATTTCGGTGGTGATG-1	GFAP_GBM
TCAAGACAGGATTCCT-1	MEGF11_GBM
TCAAGACAGGTTGCCC-1	Normal
TCAAGACAGTAATTGG-1	Normal
TCAAGACAGTTTCGAC-1	MEGF11_GBM
TCAAGACCAATAACGA-1	Normal
TCAAGACCAATTCGTG-1	Normal
TCAAGACCACGTCGTG-1	GFAP_GBM
TCAAGACGTGACTGAG-1	VEGFA_GBM
TCAAGCAAGACGCAGT-1	MEGF11_GBM
TCAAGCACAACGAGGT-1	Normal
TCAAGCAGTCTTCGAA-1	Normal
TCAAGCAGTCTTGAGT-1	Normal
TCAAGCAGTGAAGCGT-1	MEGF11_GBM
TCAAGCATCCATCCGT-1	Normal
TCAAGTGAGACGCCAA-1	Normal
TCAAGTGAGTAGGCCA-1	GFAP_GBM
TCAAGTGCATACAGGG-1	VEGFA_GBM
TCAAGTGTCCGTGGGT-1	Normal
TCAAGTGTCCTGTTGC-1	MEGF11_GBM
TCAAGTGTCTAGTTCT-1	GFAP_GBM
TCAAGTGTCTCGTCGT-1	Normal
TCAATCTCAATCCAGT-1	Normal
TCAATCTGTGAACTAA-1	Normal
TCAATCTTCTTCTGGC-1	Normal
TCAATTCAGCCTAACT-1	Normal
TCAATTCCAGCTCATA-1	Normal
TCAATTCCATTGTAGC-1	Normal
TCAATTCTCTATACTC-1	GFAP_GBM
TCAATTCTCTCTCTTC-1	Normal
TCACAAGAGAGTTGCG-1	Normal
TCACAAGGTACCAGAG-1	Normal
TCACAAGTCGATACAC-1	Normal
TCACACCGTATTCTCT-1	Normal
TCACACCGTCCTGGGT-1	Normal
TCACACCGTCTCGCGA-1	GFAP_GBM
TCACACCGTTTAGTCG-1	Normal
TCACACCTCCATTCGC-1	Normal
TCACATTAGACTACCT-1	Normal
TCACATTAGAGCATAT-1	Normal
TCACATTAGCATGTTC-1	Normal
TCACATTCAAGAGGTC-1	GFAP_GBM
TCACATTCATGTGTCA-1	Normal
TCACATTGTTCCGCGA-1	Normal
TCACATTGTTGGATCT-1	MEGF11_GBM
TCACATTTCAATCTTC-1	MEGF11_GBM
TCACATTTCAGCTTCC-1	Normal
TCACGCTCACGTTGGC-1	Normal
TCACGCTCAGGTGAGT-1	VEGFA_GBM
TCACGCTGTCCTCCAT-1	Normal
TCACGCTGTTCGGTTA-1	Normal
TCACGCTGTTTGGCTA-1	Normal
TCACGCTTCTTTCCGG-1	Normal
TCACGGGAGACAGCGT-1	Normal
TCACGGGAGTAACAGT-1	GFAP_GBM
TCACGGGTCACGACTA-1	MEGF11_GBM
TCACGGGTCATCCTGC-1	Normal
TCACGGGTCCACTGGG-1	MEGF11_GBM
TCACTATCAGGCTCTG-1	Normal
TCACTATCATAGGTAA-1	MEGF11_GBM
TCACTCGAGAGCTGCA-1	VEGFA_GBM
TCACTCGCAGACCTAT-1	Normal
TCACTCGGTTGAAGTA-1	VEGFA_GBM
TCACTCGGTTGTAGCT-1	GFAP_GBM
TCACTCGTCCTACACC-1	MEGF11_GBM
TCAGCAACAAATGGAT-1	GFAP_GBM
TCAGCAACACACGCCA-1	Normal
TCAGCAAGTTTGGCTA-1	Normal
TCAGCAATCAAGCTGT-1	VEGFA_GBM
TCAGCCTAGAAGCGAA-1	VEGFA_GBM
TCAGCCTAGCAATAGT-1	MEGF11_GBM
TCAGCCTCACCACATA-1	Normal
TCAGCCTCATAACAGA-1	Normal
TCAGCCTGTTGTTGCA-1	VEGFA_GBM
TCAGCCTTCCCGGTAG-1	VEGFA_GBM
TCAGCCTTCCGCGAGT-1	Normal
TCAGCCTTCGTGTTCC-1	Normal
TCAGGGCGTGCCTTCT-1	Normal
TCAGGGCTCCTTATGT-1	Normal
TCAGGTACAACTGAAA-1	Normal
TCAGGTACAGCGCGTT-1	Normal
TCAGTCCAGAGGGTAA-1	Normal
TCAGTCCAGCTGACTT-1	GFAP_GBM
TCAGTCCGTTCCGTTC-1	MEGF11_GBM
TCAGTCCTCAACACCA-1	MEGF11_GBM
TCAGTCCTCCTGTAAG-1	VEGFA_GBM
TCAGTCCTCTAAGCCA-1	Normal
TCAGTCCTCTGACAGT-1	MEGF11_GBM
TCAGTGAAGCGTCGAA-1	Normal
TCAGTGAAGTCACTAC-1	VEGFA_GBM
TCAGTGACAAGAGTAT-1	MEGF11_GBM
TCAGTGAGTCTAGGCC-1	Normal
TCAGTTTCACGCGTGT-1	Normal
TCAGTTTGTATGAGGC-1	Normal
TCATACTAGATCCTAC-1	MEGF11_GBM
TCATACTAGTCACTCA-1	Normal
TCATACTCAAGCGAGT-1	Normal
TCATACTTCGAATCCA-1	MEGF11_GBM
TCATATCAGAGCAGAA-1	Normal
TCATATCAGATAGGGA-1	Normal
TCATATCGTCGCTGCA-1	MEGF11_GBM
TCATATCTCCACCTGT-1	Normal
TCATATCTCGACACCG-1	Normal
TCATATCTCGCCGATG-1	Normal
TCATCATAGGCCTAGA-1	Normal
TCATCATGTACTGACT-1	MEGF11_GBM
TCATCATGTGCCGTTG-1	Normal
TCATCATGTTTGCCGG-1	Normal
TCATCATTCCGCGGAT-1	Clone_2nd
TCATCATTCTACCTTA-1	Normal
TCATCATTCTGAGGCC-1	VEGFA_GBM
TCATCCGAGTAGGATT-1	MEGF11_GBM
TCATCCGCAAAGAACT-1	Normal
TCATCCGCAAAGGGCT-1	Normal
TCATCCGCAACAGATA-1	Normal
TCATCCGGTCCACAGC-1	GFAP_GBM
TCATGAGTCGCGGACT-1	MEGF11_GBM
TCATGCCAGCAAGTGC-1	Normal
TCATGCCAGCCAGAGT-1	Normal
TCATGCCCAAACGGCA-1	Normal
TCATGCCCAGTCTTCC-1	Normal
TCATGCCGTGTATACC-1	Normal
TCATGCCTCTTCGTGC-1	MEGF11_GBM
TCATGGAAGCTAAATG-1	MEGF11_GBM
TCATGGAAGGCAGGGA-1	VEGFA_GBM
TCATGGACAAACTCGT-1	VEGFA_GBM
TCATGGAGTACGTAGG-1	Normal
TCATGGAGTTCGGTAT-1	MEGF11_GBM
TCATGGATCCGTCAAA-1	VEGFA_GBM
TCATGTTAGGTTGCCC-1	Normal
TCATGTTCATATTCGG-1	Normal
TCATGTTGTAGTATAG-1	Normal
TCATGTTGTGAGATCG-1	Normal
TCATGTTTCACTTGGA-1	GFAP_GBM
TCATGTTTCCACCCTA-1	VEGFA_GBM
TCATGTTTCCCATTTA-1	Normal
TCATTACGTCGTCGGT-1	GFAP_GBM
TCATTACGTCTACTGA-1	Normal
TCATTACGTGTCATCA-1	Normal
TCATTACGTGTGTCGC-1	GFAP_GBM
TCATTCAAGAACGCGT-1	Clone_2nd
TCATTCAAGTAATTGG-1	GFAP_GBM
TCATTCAGTCCAGTTA-1	GFAP_GBM
TCATTCAGTGGCCACT-1	GFAP_GBM
TCATTCAGTTGACTAC-1	GFAP_GBM
TCATTGTCACTATCCC-1	Normal
TCATTGTGTAGATCCT-1	Normal
TCATTGTGTGGACAGT-1	Normal
TCATTTGAGCGGTATG-1	GFAP_GBM
TCATTTGAGGGTATAT-1	Normal
TCATTTGCAGCAGATG-1	GFAP_GBM
TCATTTGCAGTAGAAT-1	Normal
TCATTTGTCCCGAGAC-1	GFAP_GBM
TCCACCAAGAGCCTGA-1	Normal
TCCACCAAGGAGAATG-1	MEGF11_GBM
TCCACCAAGTGGTGAC-1	Normal
TCCACCAGTGGTAATA-1	MEGF11_GBM
TCCACCATCACGGGAA-1	MEGF11_GBM
TCCACCATCTACCACC-1	GFAP_GBM
TCCACGTAGGAGGGTG-1	Normal
TCCACGTAGGATACAT-1	GFAP_GBM
TCCACGTAGGATCACG-1	MEGF11_GBM
TCCACGTAGTCGTTAC-1	VEGFA_GBM
TCCACGTCATCCGTGG-1	Normal
TCCACGTGTCGCTGCA-1	Normal
TCCACGTGTGTTAGCT-1	VEGFA_GBM
TCCACGTGTTGTAGCT-1	Normal
TCCAGAACAGGCACTC-1	MEGF11_GBM
TCCAGAACATCGTTCC-1	Normal
TCCAGAAGTTGGATCT-1	VEGFA_GBM
TCCATCGAGTGTCATC-1	VEGFA_GBM
TCCATCGCAATCTAGC-1	Normal
TCCATCGCACCTCTAC-1	Normal
TCCATCGTCCCAGCGA-1	Normal
TCCATCGTCGAGAGCA-1	Normal
TCCATGCAGGATACAT-1	Normal
TCCATGCCATTCCTCG-1	Normal
TCCATGCGTCTCGACG-1	Normal
TCCATGCTCTAGCCAA-1	MEGF11_GBM
TCCCACACACAGACGA-1	GFAP_GBM
TCCCACATCAAACCCA-1	Normal
TCCCAGTAGTTCCGTA-1	Normal
TCCCAGTAGTTGGAGC-1	Normal
TCCCAGTCAGCCCACA-1	Normal
TCCCAGTCAGTAACCT-1	Normal
TCCCAGTGTGTCCACG-1	Normal
TCCCAGTGTGTCCGGT-1	Normal
TCCCAGTGTTGACTAC-1	Normal
TCCCAGTTCAACACGT-1	GFAP_GBM
TCCCATGCACAGTCCG-1	MEGF11_GBM
TCCCATGGTACTGGGA-1	GFAP_GBM
TCCCATGGTCTCTCTG-1	Normal
TCCCATGGTGAATTAG-1	GFAP_GBM
TCCCATGTCTTGAGCA-1	MEGF11_GBM
TCCGAAAAGATTACCC-1	Normal
TCCGAAACATTCAGGT-1	MEGF11_GBM
TCCGATCCAAGTGGTG-1	Normal
TCCGATCGTCCAAAGG-1	Normal
TCCGATCGTTCCATTT-1	GFAP_GBM
TCCGGGAAGACTGGGT-1	Normal
TCCGGGAAGCGTTACT-1	Normal
TCCGGGAAGGACTATA-1	Normal
TCCGGGACACATGACT-1	Normal
TCCGGGACACTGAGGA-1	GFAP_GBM
TCCGGGACACTGAGTT-1	Normal
TCCGGGAGTGGCATCC-1	Normal
TCCGGGATCGGACAAG-1	Normal
TCCGGGATCGTTAGAC-1	Normal
TCCGTGTGTACAGCGA-1	GFAP_GBM
TCCGTGTTCTGATTCT-1	Normal
TCCGTGTTCTGGGCCA-1	Normal
TCCTAATAGTAACGAT-1	Normal
TCCTAATCACACAGAG-1	Normal
TCCTAATCATGCGGTC-1	MEGF11_GBM
TCCTCCCAGAGCGACT-1	Normal
TCCTCCCAGCTAGAGC-1	GFAP_GBM
TCCTCCCAGCTGACAG-1	GFAP_GBM
TCCTCCCCAATGGGTG-1	Normal
TCCTCCCCAGCTGAAG-1	Normal
TCCTCCCGTTAGGACG-1	MEGF11_GBM
TCCTCCCTCTATCACT-1	GFAP_GBM
TCCTCCCTCTCGCAGG-1	Normal
TCCTCCCTCTGTCTCG-1	MEGF11_GBM
TCCTCGAAGCCTGAGA-1	Normal
TCCTCGAAGGGTTTCT-1	Normal
TCCTCGACAGATACTC-1	Normal
TCCTCGATCGCTAAAC-1	Normal
TCCTCTTAGCTCCACG-1	MEGF11_GBM
TCCTCTTAGGACGCTA-1	VEGFA_GBM
TCCTCTTAGTCTGCAT-1	GFAP_GBM
TCCTCTTCAATCCTAG-1	VEGFA_GBM
TCCTCTTTCGCGTGAC-1	Normal
TCCTGCAAGCACTAGG-1	MEGF11_GBM
TCCTGCAAGCCTCTTC-1	MEGF11_GBM
TCCTGCAAGCTAGTTC-1	MEGF11_GBM
TCCTGCAAGCTGAAAT-1	Normal
TCCTGCACAAGCGGAT-1	Normal
TCCTGCACACCTTCCA-1	Normal
TCCTGCACAGTCTACA-1	Normal
TCCTGCACATATGGCT-1	GFAP_GBM
TCCTTCTAGGAACTAT-1	Normal
TCCTTCTCAATGGCAG-1	Normal
TCCTTCTCATCTAGAC-1	GFAP_GBM
TCCTTCTGTATGTCCA-1	GFAP_GBM
TCCTTCTTCTAGTACG-1	Normal
TCCTTTCAGATGTTGA-1	Normal
TCCTTTCCAAATTAGG-1	Normal
TCCTTTCCAAGACGAC-1	GFAP_GBM
TCCTTTCCAAGATGTA-1	Normal
TCCTTTCCATATCTGG-1	Normal
TCCTTTCGTGCACATT-1	Normal
TCCTTTCGTTGTTGTG-1	MEGF11_GBM
TCCTTTCTCCTAGCGG-1	Normal
TCCTTTCTCTCTTAAC-1	MEGF11_GBM
TCCTTTCTCTGCCCTA-1	Normal
TCGAACAAGGATAATC-1	Normal
TCGAACAAGGTGGCTA-1	Normal
TCGAACAGTACACGTT-1	MEGF11_GBM
TCGAAGTCAACGCCCA-1	Normal
TCGAAGTCAACGTAAA-1	GFAP_GBM
TCGAAGTCAAGGACAC-1	Normal
TCGAAGTCAGGTTCGC-1	Normal
TCGAAGTCAGTACTAC-1	MEGF11_GBM
TCGAAGTCATAGTCGT-1	VEGFA_GBM
TCGAAGTGTCTCAAGT-1	Normal
TCGAAGTGTTAAACAG-1	Normal
TCGAAGTTCCATGATG-1	MEGF11_GBM
TCGAAGTTCGGTCTAA-1	Normal
TCGACCTAGAATAGTC-1	Normal
TCGACCTCACCAGCTG-1	VEGFA_GBM
TCGACCTGTGGTAACG-1	VEGFA_GBM
TCGACCTTCCGGACGT-1	Normal
TCGACGGCAATCGCCG-1	Normal
TCGACGGGTCGGTGAA-1	Normal
TCGACGGTCATGTCAG-1	Normal
TCGACGGTCGTAGCCG-1	Normal
TCGATTTGTCGAATGG-1	GFAP_GBM
TCGATTTTCATTGCTT-1	MEGF11_GBM
TCGCACTCAAAGTATG-1	Normal
TCGCACTCAAGAAATC-1	MEGF11_GBM
TCGCACTTCTCTTGCG-1	Normal
TCGCAGGCAACTGCTA-1	Normal
TCGCAGGGTACCATAC-1	GFAP_GBM
TCGCAGGGTACGACAG-1	GFAP_GBM
TCGCAGGTCCGGCAGT-1	Normal
TCGCAGGTCGAAGCAG-1	Normal
TCGCTCAAGCTATCCA-1	Normal
TCGCTCACAATAAGGT-1	GFAP_GBM
TCGCTCACATATGGCT-1	GFAP_GBM
TCGCTCAGTCCTGGTG-1	VEGFA_GBM
TCGCTCAGTTGGTAGG-1	Normal
TCGCTCATCACTCGAA-1	MEGF11_GBM
TCGCTCATCTGGTGCG-1	VEGFA_GBM
TCGCTCATCTTCGATT-1	VEGFA_GBM
TCGCTTGAGCTTCATG-1	Normal
TCGCTTGAGTTACGAA-1	Normal
TCGCTTGCACTCTCGT-1	GFAP_GBM
TCGCTTGCATCTAGAC-1	MEGF11_GBM
TCGCTTGGTCCGTTTC-1	Normal
TCGCTTGGTTGCAACT-1	GFAP_GBM
TCGCTTGTCGATTCCC-1	Normal
TCGGATAAGATAGGGA-1	Normal
TCGGATAAGATGACCG-1	Normal
TCGGATAAGGGATCTG-1	MEGF11_GBM
TCGGATACACTGATTG-1	Normal
TCGGATATCCTACTGC-1	Normal
TCGGATATCTCAACCC-1	Normal
TCGGGACAGCTAATGA-1	Normal
TCGGGACGTAGAGCTG-1	GFAP_GBM
TCGGGACGTATACAGA-1	Normal
TCGGGACGTATGTCTG-1	VEGFA_GBM
TCGGGACGTGAACCGA-1	Normal
TCGGGACTCAGACCGC-1	Normal
TCGGGACTCCTCAGGG-1	MEGF11_GBM
TCGGGACTCTTGAGCA-1	MEGF11_GBM
TCGGGCAAGGGACTGT-1	MEGF11_GBM
TCGGGCAAGTACAACA-1	Normal
TCGGGCAAGTCTCTGA-1	Normal
TCGGGCACAGCAGACA-1	VEGFA_GBM
TCGGGCATCTTGGAAC-1	MEGF11_GBM
TCGGGTGAGCAAACAT-1	Normal
TCGGGTGAGGGTTGCA-1	VEGFA_GBM
TCGGGTGCAGGTCAAG-1	VEGFA_GBM
TCGGGTGGTAAGTCAA-1	Normal
TCGGGTGGTCCATACA-1	Normal
TCGGGTGGTGGAAGTC-1	Normal
TCGGGTGTCTAGGAAA-1	Normal
TCGGGTGTCTCGCCTA-1	MEGF11_GBM
TCGGGTGTCTTCCCAG-1	Normal
TCGGTCTAGATACAGT-1	GFAP_GBM
TCGGTCTCAAACGAGC-1	Clone_2nd
TCGGTCTCAAAGGCAC-1	Normal
TCGGTCTGTGTCGCTG-1	Normal
TCGGTCTGTTTAGAGA-1	GFAP_GBM
TCGTAGAAGTCCTGCG-1	Normal
TCGTAGACAATCCTTT-1	Normal
TCGTAGACAGCTCTGG-1	Normal
TCGTAGACAGTTGCGC-1	MEGF11_GBM
TCGTAGATCTCAACCC-1	Normal
TCGTAGATCTCTATAC-1	Normal
TCGTCCAAGTCGCTAT-1	MEGF11_GBM
TCGTCCAGTCCACATA-1	GFAP_GBM
TCGTCCATCCCATAAG-1	Normal
TCGTCCATCCTACTGC-1	Normal
TCGTGCTCACTATCCC-1	Normal
TCGTGCTGTCGCACAC-1	Normal
TCGTGCTGTTGGGTAG-1	VEGFA_GBM
TCGTGGGCAGCTCATA-1	Normal
TCGTGGGGTTGCACGC-1	Normal
TCTAACTAGGCATGCA-1	Normal
TCTAACTAGTGGTGAC-1	GFAP_GBM
TCTAACTTCAACTGAC-1	Normal
TCTACATAGCTCCCTT-1	Normal
TCTACATCACCCAATA-1	Normal
TCTACATGTCTCACGG-1	Normal
TCTACATGTTCGTGCG-1	Normal
TCTACATTCACCTTAT-1	Normal
TCTACATTCAGCCCAG-1	Normal
TCTACATTCCATCTGC-1	VEGFA_GBM
TCTACATTCGCCGAAC-1	MEGF11_GBM
TCTACCGCAAGCCTGC-1	Normal
TCTACCGGTCTGTAAC-1	MEGF11_GBM
TCTACCGTCAGCACCG-1	Normal
TCTATACCAAAGAGTT-1	GFAP_GBM
TCTATACGTCCTGGGT-1	GFAP_GBM
TCTATACGTGGAGAAA-1	Normal
TCTATACTCTAGACCA-1	Normal
TCTATCACAGCGTTGC-1	Normal
TCTATCAGTAGTAAGT-1	GFAP_GBM
TCTATCAGTCGTATTG-1	Normal
TCTATCATCATGGATC-1	GFAP_GBM
TCTATCATCGCAATTG-1	VEGFA_GBM
TCTCACGAGCGCTGCT-1	GFAP_GBM
TCTCACGAGTCGAAAT-1	Normal
TCTCACGCAACTGAAA-1	Normal
TCTCAGCAGGCTAAAT-1	GFAP_GBM
TCTCAGCAGTGAGTTA-1	GFAP_GBM
TCTCAGCCACGAGGAT-1	Normal
TCTCAGCGTGGCCCAT-1	GFAP_GBM
TCTCCGAAGAGGGTCT-1	Normal
TCTCCGAGTTCTGAGT-1	Normal
TCTCTGGAGCAGCAGT-1	GFAP_GBM
TCTCTGGAGTGGTGGT-1	GFAP_GBM
TCTCTGGCAGTGCGCT-1	Normal
TCTCTGGCATGTCAGT-1	GFAP_GBM
TCTCTGGGTCCTACGG-1	Normal
TCTGCCAAGCAAGTGC-1	VEGFA_GBM
TCTGCCACATCAACCA-1	MEGF11_GBM
TCTGCCATCACTGATG-1	Normal
TCTGCCATCTTAGTTC-1	Normal
TCTGGCTCAAACTAAG-1	Normal
TCTGGCTTCGCAAGAG-1	GFAP_GBM
TCTGTCGAGCATCAAA-1	MEGF11_GBM
TCTGTCGAGCATTGTC-1	Normal
TCTGTCGAGCTTTCTT-1	Normal
TCTGTCGCACGGCACT-1	Normal
TCTGTCGGTATGGAAT-1	GFAP_GBM
TCTGTCGGTGTCCCTT-1	Normal
TCTTAGTAGACTAAGT-1	MEGF11_GBM
TCTTAGTCAACACACT-1	Normal
TCTTCCTAGGTCGACA-1	Normal
TCTTCCTCAAGAATAC-1	Normal
TCTTCCTCACCATAAC-1	Normal
TCTTCCTCAGACAATA-1	Normal
TCTTCCTCATAAGCGG-1	Normal
TCTTCCTGTAGACGTG-1	GFAP_GBM
TCTTCCTGTCGCATCG-1	VEGFA_GBM
TCTTCCTGTGAGTCAG-1	Normal
TCTTCCTTCTGTGCTC-1	Normal
TCTTGCGAGGCACTAG-1	VEGFA_GBM
TCTTGCGCAGCTGAGA-1	Normal
TCTTGCGGTCCTCCAT-1	Normal
TCTTGCGTCAAGCTTG-1	GFAP_GBM
TCTTGCGTCCGTGTGG-1	Normal
TCTTTGACAGGCTCTG-1	GFAP_GBM
TCTTTGAGTCTTCAAG-1	MEGF11_GBM
TCTTTGATCTATACTC-1	Normal
TGAACGTAGACTCAAA-1	MEGF11_GBM
TGAACGTCACGCAGTC-1	Normal
TGAACGTCACTGGAAG-1	Normal
TGAACGTGTACTAGCT-1	Normal
TGAACGTTCGCTCATC-1	GFAP_GBM
TGAATCGAGAGGTTTA-1	Normal
TGAATCGCATGACTGT-1	Normal
TGAATCGGTTTGGCTA-1	Normal
TGAATCGTCCGTGGCA-1	Normal
TGAATGCCATGAAGCG-1	Normal
TGAATGCCATTCTTCA-1	Normal
TGAATGCTCGCAGTCG-1	Normal
TGACAGTGTCACTCGG-1	Normal
TGACAGTGTCATCCCT-1	Normal
TGACAGTTCCCTTCCC-1	Normal
TGACAGTTCTCTGCTG-1	Clone_2nd
TGACCCTAGCAGTAAT-1	VEGFA_GBM
TGACCCTCAATGAAAC-1	MEGF11_GBM
TGACCCTCATGTTCGA-1	Normal
TGACCCTTCGCTACAA-1	MEGF11_GBM
TGACGCGCAACGTATC-1	Normal
TGACGCGCATCTTCGC-1	VEGFA_GBM
TGACGCGGTCTAGGTT-1	VEGFA_GBM
TGACTCCAGAAGTGTT-1	GFAP_GBM
TGACTCCAGCAGAAAG-1	GFAP_GBM
TGACTCCAGCCTATTG-1	Normal
TGACTCCAGTAAACGT-1	Normal
TGACTCCAGTTGCGCC-1	Normal
TGACTCCCAAGGAGTC-1	Normal
TGACTCCGTACAGGTG-1	MEGF11_GBM
TGACTCCGTCGTTGCG-1	Normal
TGACTCCGTGCGAACA-1	VEGFA_GBM
TGACTCCTCAACTGAC-1	MEGF11_GBM
TGACTCCTCATGCTAG-1	Normal
TGAGACTAGAATCGCG-1	Normal
TGAGACTAGCAGGGAG-1	Normal
TGAGACTCAACGGTAG-1	Normal
TGAGACTGTCTCCCTA-1	MEGF11_GBM
TGAGACTGTGACACGA-1	MEGF11_GBM
TGAGACTTCGCATTGA-1	Normal
TGAGCATCAAAGCACG-1	Normal
TGAGCATGTGGTACAG-1	Normal
TGAGCATGTTGTGTTG-1	Normal
TGAGCATTCGTAATGC-1	GFAP_GBM
TGAGCGCAGCTGAAGC-1	MEGF11_GBM
TGAGCGCCAGGTGACA-1	Normal
TGAGCGCTCCCTTTGG-1	MEGF11_GBM
TGAGGAGAGTTCTCTT-1	Normal
TGAGGAGCAATGTCTG-1	GFAP_GBM
TGAGGAGCATCATCTT-1	Normal
TGAGGAGTCCGGCAAC-1	Normal
TGAGGGATCATCTACT-1	Normal
TGAGGTTGTGTGTACT-1	Normal
TGAGGTTGTTGGAGGT-1	Normal
TGAGGTTGTTTGAACC-1	MEGF11_GBM
TGAGGTTTCCGTAATG-1	GFAP_GBM
TGAGGTTTCTTGATTC-1	MEGF11_GBM
TGAGTCAAGGCGCTCT-1	Normal
TGAGTCACACCTCGTT-1	Normal
TGAGTCACACTCAGAT-1	Normal
TGAGTCAGTTCTCGCT-1	GFAP_GBM
TGAGTCATCCTACAAG-1	VEGFA_GBM
TGATCAGAGACCATAA-1	VEGFA_GBM
TGATCAGAGCAGGCAT-1	Normal
TGATCAGAGCGTGTTT-1	MEGF11_GBM
TGATCAGAGGCGAAGG-1	Normal
TGATCAGCACGAAAGC-1	Normal
TGATCAGTCAACGTGT-1	Normal
TGATCAGTCTTAATCC-1	Normal
TGATCTTAGGAGACCT-1	Normal
TGATCTTCAGAACATA-1	MEGF11_GBM
TGATCTTCAGGAACCA-1	Normal
TGATCTTGTGCCTACG-1	Normal
TGATCTTGTGCGAACA-1	Normal
TGATCTTTCCCTCTAG-1	MEGF11_GBM
TGATGCAGTGACTATC-1	GFAP_GBM
TGATGCAGTTTGCAGT-1	Normal
TGATGCATCCGGTAGC-1	Normal
TGATGCATCGTTCTAT-1	Normal
TGATGGTAGATCACCT-1	MEGF11_GBM
TGATGGTAGCAATTAG-1	Normal
TGATGGTAGTAATACG-1	Normal
TGATGGTGTCATCGCG-1	Normal
TGATGGTGTCTTGCGG-1	GFAP_GBM
TGATGGTTCTCATTTG-1	Clone_2nd
TGATTCTAGGTCTGGA-1	Normal
TGATTCTGTAGAGTTA-1	VEGFA_GBM
TGATTCTGTCTCAGAT-1	Normal
TGATTTCAGCGTTCAT-1	GFAP_GBM
TGATTTCCAGAAATCA-1	MEGF11_GBM
TGATTTCTCAGACAAA-1	Normal
TGCACGGAGCGTTCAT-1	Normal
TGCAGATAGGGTCTTT-1	Normal
TGCAGATAGTTGCCCG-1	GFAP_GBM
TGCAGATCACTCTAGA-1	MEGF11_GBM
TGCAGATCATCCTTCG-1	Normal
TGCAGATGTAATTGGA-1	Clone_2nd
TGCAGATGTGCATGAG-1	VEGFA_GBM
TGCAGATTCAACACGT-1	MEGF11_GBM
TGCAGATTCGGTCGAC-1	Normal
TGCAGGCAGCCGAATG-1	Normal
TGCAGGCAGGGTTTCT-1	MEGF11_GBM
TGCAGGCGTGAACGGT-1	Normal
TGCAGGCTCAATGTCG-1	Normal
TGCAGTAAGGCCCAAA-1	GFAP_GBM
TGCAGTAAGTACAACA-1	MEGF11_GBM
TGCAGTACAGGCGTTC-1	Normal
TGCAGTAGTCAGGTAG-1	Normal
TGCAGTATCAGTGATC-1	MEGF11_GBM
TGCATCCAGAAGGCTC-1	Normal
TGCATCCAGCGCCTTG-1	Normal
TGCATCCCATCCGGTG-1	Normal
TGCATCCGTGACCGTC-1	Normal
TGCATGAGTACCTAGT-1	GFAP_GBM
TGCATGAGTGCTTATG-1	GFAP_GBM
TGCATGAGTTATGTCG-1	Normal
TGCATGATCCCTTTGG-1	MEGF11_GBM
TGCCGAGAGTCGAAAT-1	MEGF11_GBM
TGCCGAGAGTTGTAAG-1	VEGFA_GBM
TGCCGAGCACCCTGAG-1	MEGF11_GBM
TGCCGAGCAGGGAATC-1	MEGF11_GBM
TGCCGAGGTCACTGAT-1	GFAP_GBM
TGCCGAGGTGGTCCCA-1	MEGF11_GBM
TGCCGAGTCCCTCTCC-1	MEGF11_GBM
TGCGACGCAATTGTGC-1	GFAP_GBM
TGCGACGCAGAAACCG-1	GFAP_GBM
TGCGACGGTCCTGGGT-1	VEGFA_GBM
TGCGATAAGAAACTGT-1	Normal
TGCGATACAAGATGTA-1	Normal
TGCGATAGTGCGAACA-1	Normal
TGCGATATCTGTCGCT-1	Normal
TGCGGCATCCGGACGT-1	GFAP_GBM
TGCGGCATCCTAGCTC-1	GFAP_GBM
TGCGGCATCGAGATAA-1	Normal
TGCGGCATCTAATTCC-1	GFAP_GBM
TGCGGGTCAATTAGGA-1	Normal
TGCGGGTGTCACGCTG-1	Normal
TGCGGGTGTTACAGCT-1	Normal
TGCGGGTTCCTACTGC-1	Normal
TGCTCCAAGCAGCAGT-1	Normal
TGCTCCACAAGAGTAT-1	VEGFA_GBM
TGCTCCATCACAAGAA-1	Normal
TGCTCCATCCCTCAAC-1	Normal
TGCTCCATCTGAATCG-1	MEGF11_GBM
TGCTCGTCATCGGTTA-1	MEGF11_GBM
TGCTGAAAGGATACAT-1	Normal
TGCTGAACAGTAGTGG-1	MEGF11_GBM
TGCTGAACATACCGTA-1	Normal
TGCTGAATCAGTGGGA-1	MEGF11_GBM
TGCTGAATCTCCGAGG-1	Normal
TGCTTCGAGGCTCAAG-1	Clone_2nd
TGCTTCGAGGTCCCGT-1	Normal
TGCTTCGCAGACCATT-1	Normal
TGCTTCGCATGGAACG-1	Normal
TGCTTGCAGGCCACTC-1	Normal
TGCTTGCGTATGGTAA-1	MEGF11_GBM
TGCTTGCGTATTAAGG-1	MEGF11_GBM
TGCTTGCTCGAGCACC-1	MEGF11_GBM
TGGAACTAGCCGTAAG-1	MEGF11_GBM
TGGAACTAGGTATTGA-1	Normal
TGGAACTAGGTGGGTT-1	MEGF11_GBM
TGGAACTCATGAATCC-1	MEGF11_GBM
TGGAACTGTACTTGTG-1	Normal
TGGAACTGTTCTCAGA-1	Normal
TGGAGAGAGTTCCAGT-1	Normal
TGGAGAGGTTGACGGA-1	GFAP_GBM
TGGAGGACACATACTG-1	MEGF11_GBM
TGGAGGAGTGAGTGAC-1	Normal
TGGAGGATCCACTTTA-1	Normal
TGGAGGATCGCCACTT-1	VEGFA_GBM
TGGAGGATCTCTGAGA-1	MEGF11_GBM
TGGATCAAGTCCTGTA-1	Normal
TGGATCACACACTTAG-1	MEGF11_GBM
TGGATCACACTGTCGG-1	Normal
TGGATCAGTTGTACGT-1	VEGFA_GBM
TGGATCATCCACTGGG-1	Normal
TGGATCATCCGTGTCT-1	MEGF11_GBM
TGGATGTAGATTGAGT-1	GFAP_GBM
TGGATGTAGCATGATA-1	Normal
TGGATGTCAACACGAG-1	Normal
TGGATGTCAGAACTTC-1	Normal
TGGATGTGTATTGGCT-1	MEGF11_GBM
TGGATGTGTCGTAATC-1	Normal
TGGATGTTCCTTCGAC-1	Normal
TGGATGTTCTGACAGT-1	GFAP_GBM
TGGCGTGAGAAAGTCT-1	Normal
TGGCGTGCATAGGTAA-1	MEGF11_GBM
TGGCGTGTCACTTGTT-1	Normal
TGGCGTGTCCCTCGTA-1	VEGFA_GBM
TGGCGTGTCGTTGTTT-1	Normal
TGGGAAGCAGTCGTTA-1	Normal
TGGGAAGCATTGACCA-1	Normal
TGGGAAGGTGGACTGA-1	Normal
TGGGAAGTCACCCTGT-1	Normal
TGGGAAGTCATTCCTA-1	MEGF11_GBM
TGGGAGAAGAATCTAG-1	MEGF11_GBM
TGGGAGACAATGCTCA-1	Normal
TGGGAGACAGCTGTCG-1	MEGF11_GBM
TGGGAGAGTATTGAGA-1	Normal
TGGGAGAGTCACAGTT-1	MEGF11_GBM
TGGGAGATCTTAATCC-1	Normal
TGGGATTAGGCCCAAA-1	Normal
TGGGATTCATGCGGTC-1	Normal
TGGGATTGTGAGCAGT-1	GFAP_GBM
TGGGATTGTTCTTGCC-1	Normal
TGGGATTGTTGTCCCT-1	GFAP_GBM
TGGGCGTAGGTACATA-1	Normal
TGGGCGTCAGCTATAC-1	Normal
TGGGCGTGTTCAGTAC-1	Normal
TGGGCGTTCGACATAC-1	Normal
TGGGCTGAGTAGACCG-1	Clone_2nd
TGGGCTGCAATACCCA-1	Normal
TGGGCTGCAGGTGACA-1	Normal
TGGGCTGTCCGTGTGG-1	Normal
TGGGCTGTCGGAGCAA-1	Normal
TGGGTTAAGGTCACAG-1	Normal
TGGGTTAGTAGTCACT-1	Normal
TGGGTTATCGCTATTT-1	Normal
TGGGTTATCGGTTCAA-1	VEGFA_GBM
TGGTACAAGAGCAAGA-1	Normal
TGGTACAAGATCGCTT-1	Normal
TGGTACAAGGCTCCCA-1	Normal
TGGTACAAGTGGTTAA-1	Normal
TGGTACACAAACCGGA-1	VEGFA_GBM
TGGTACACAGAAATTG-1	MEGF11_GBM
TGGTACATCGCAACAT-1	Normal
TGGTACATCTAGTCAG-1	Clone_2nd
TGGTAGTAGCCTGACC-1	GFAP_GBM
TGGTAGTCAATAGTGA-1	Normal
TGGTAGTCACCGTGGT-1	MEGF11_GBM
TGGTAGTTCAAAGGTA-1	MEGF11_GBM
TGGTAGTTCCGAAATC-1	GFAP_GBM
TGGTGATCAGGAATAT-1	Normal
TGGTGATCAGTGTGCC-1	Normal
TGGTGATGTACACGTT-1	Normal
TGGTGATTCACCGCTT-1	Normal
TGGTGATTCACCTCGT-1	Normal
TGGTTAGAGCCATCCG-1	Normal
TGGTTAGGTAGTCCTA-1	Normal
TGGTTAGTCACAGTGT-1	GFAP_GBM
TGTAACGAGATACCAA-1	VEGFA_GBM
TGTAACGAGCTGCCAC-1	GFAP_GBM
TGTAACGAGGCTCAAG-1	Normal
TGTAACGAGTCACAGG-1	Normal
TGTAACGGTCAACATC-1	Normal
TGTAACGGTTTCGTGA-1	Normal
TGTAACGTCACAAGGG-1	MEGF11_GBM
TGTAACGTCTGTACAG-1	Normal
TGTAAGCAGTTGTAGA-1	Normal
TGTAAGCGTGTCCATA-1	Normal
TGTAAGCTCTAAGCCA-1	MEGF11_GBM
TGTACAGAGCGAAACC-1	Normal
TGTACAGAGCTCAGAG-1	Normal
TGTAGACCAGAGTGTG-1	Normal
TGTAGACTCCATTTCA-1	MEGF11_GBM
TGTCAGACAATATCCG-1	Normal
TGTCAGACACTCTAGA-1	VEGFA_GBM
TGTCAGACAGACTGCC-1	Normal
TGTCAGATCAAGCCGC-1	Normal
TGTCAGATCATCGCCT-1	Normal
TGTCAGATCATTATCC-1	VEGFA_GBM
TGTCCACAGCCATGCC-1	MEGF11_GBM
TGTCCACGTGCCTAAT-1	GFAP_GBM
TGTCCACGTGTGCTTA-1	MEGF11_GBM
TGTCCACGTTTGAACC-1	Normal
TGTCCACTCCTCTAAT-1	GFAP_GBM
TGTCCCAAGCTCCCTT-1	Normal
TGTCCCACAACAAGAT-1	Normal
TGTCCCACAGTAGTTC-1	Normal
TGTCCCATCACTACTT-1	Normal
TGTCCCATCCCGATCT-1	MEGF11_GBM
TGTCCCATCGTGGAAG-1	Normal
TGTCCTGAGATTCGAA-1	VEGFA_GBM
TGTCCTGCAATGAAAC-1	GFAP_GBM
TGTCCTGCACCAATTG-1	MEGF11_GBM
TGTCCTGGTCAGGTGA-1	Normal
TGTCCTGGTTGTAAAG-1	Normal
TGTCCTGTCACGGTCG-1	Normal
TGTCCTGTCGTTGTAG-1	Normal
TGTGAGTAGCCTATTG-1	Normal
TGTGAGTCAAGAATGT-1	Normal
TGTGAGTCAGAACCGA-1	Normal
TGTGAGTGTCACTCTC-1	Normal
TGTGAGTGTGAGCCAA-1	Normal
TGTGAGTGTGTCGATT-1	Normal
TGTGAGTGTGTCTCCT-1	Normal
TGTGAGTTCATCGCTC-1	MEGF11_GBM
TGTGAGTTCGTGGACC-1	Normal
TGTGATGCAAGCTACT-1	MEGF11_GBM
TGTGATGGTCAGGTGA-1	GFAP_GBM
TGTGATGGTCTCTCTG-1	Normal
TGTGCGGAGCGTTAGG-1	Normal
TGTGCGGAGTCTCTGA-1	Normal
TGTGCGGAGTGGAAAG-1	MEGF11_GBM
TGTGCGGCACCAAAGG-1	GFAP_GBM
TGTGCGGCAGGAGACT-1	Normal
TGTGCGGGTGAAGCTG-1	GFAP_GBM
TGTGCGGGTGTTGCCG-1	MEGF11_GBM
TGTGCGGTCTTCCCAG-1	MEGF11_GBM
TGTGGCGAGATCCTAC-1	Normal
TGTGGCGAGGCATCTT-1	Normal
TGTGGCGAGGGTCTTT-1	VEGFA_GBM
TGTGGCGGTCCTTGTC-1	MEGF11_GBM
TGTGGCGGTGAGTTGG-1	MEGF11_GBM
TGTGGCGGTGCTCCGA-1	MEGF11_GBM
TGTGGCGTCTACTGCC-1	MEGF11_GBM
TGTGTGAAGGGACCAT-1	MEGF11_GBM
TGTGTGAAGTAAATGC-1	MEGF11_GBM
TGTGTGACAAACAGGC-1	Normal
TGTGTGACAGAAGTGC-1	Normal
TGTGTGAGTCATCTAG-1	Normal
TGTGTGAGTCGTGGTC-1	GFAP_GBM
TGTGTGATCGTTGCCT-1	Normal
TGTTACTCATTCGATG-1	Normal
TGTTACTCATTGCAAC-1	Normal
TGTTACTGTAGGTCAG-1	GFAP_GBM
TGTTACTGTCAGGTAG-1	Normal
TGTTACTGTGCGAACA-1	Normal
TGTTACTTCGGTGCAC-1	Normal
TGTTCATAGGCTTAAA-1	Normal
TGTTCATCACGACAAG-1	Normal
TGTTCATCACGCTTAA-1	Normal
TGTTCATGTCGCCTAG-1	Normal
TGTTCCGAGATACGAT-1	MEGF11_GBM
TGTTCCGAGCAAGGAA-1	Normal
TGTTCCGAGTCTTGGT-1	Normal
TGTTCCGCAAAGGTTA-1	MEGF11_GBM
TGTTCCGGTAGTAAGT-1	Normal
TGTTCCGGTGTACGCC-1	Normal
TGTTCCGTCATCCCGT-1	Normal
TGTTCCGTCCGTACGG-1	Normal
TGTTCTAAGGCAGCTA-1	MEGF11_GBM
TGTTCTAAGGTCACAG-1	Normal
TGTTCTATCGAGAGCA-1	VEGFA_GBM
TGTTCTATCGCGGACT-1	Normal
TGTTGAGAGGAGGTTC-1	Normal
TGTTGAGCACAAGCCC-1	MEGF11_GBM
TGTTGAGCACACGGAA-1	GFAP_GBM
TGTTGAGCAGCCTTCT-1	VEGFA_GBM
TGTTGAGCATGACTTG-1	Normal
TGTTGGAAGATGGTAT-1	Normal
TGTTGGAAGCGTTAGG-1	Normal
TGTTGGAAGTAATTGG-1	Normal
TGTTGGACAACTTCTT-1	Normal
TGTTGGAGTCGGTAAG-1	Normal
TGTTTGTCACTGCTTC-1	VEGFA_GBM
TGTTTGTGTCTGTCCT-1	GFAP_GBM
TGTTTGTGTGTGAGCA-1	MEGF11_GBM
TGTTTGTTCGCGGACT-1	Normal
TTAATCCCATTGTAGC-1	Normal
TTAATCCGTTTGGGAG-1	VEGFA_GBM
TTAATCCTCAACTGGT-1	Clone_2nd
TTACAGGAGAAGCGCT-1	VEGFA_GBM
TTACAGGCACTCATAG-1	Normal
TTACAGGCACTGCATA-1	Normal
TTACAGGGTTCCGCGA-1	Normal
TTACAGGTCGGAAACG-1	VEGFA_GBM
TTACCATGTGATTAGA-1	Normal
TTACCATTCTTGTGCC-1	Normal
TTACCGCGTACAGAGC-1	GFAP_GBM
TTACCGCGTGCTAGCC-1	Normal
TTACGCCAGCAACAGC-1	GFAP_GBM
TTACGCCAGGTAGCAC-1	MEGF11_GBM
TTACGCCAGTGTCATC-1	Normal
TTACGCCGTATACCTG-1	GFAP_GBM
TTACGCCGTCGTCAGC-1	MEGF11_GBM
TTACGCCTCAACCCGG-1	Normal
TTACGTTAGGGCTAAC-1	Normal
TTACGTTAGGTCTTTG-1	MEGF11_GBM
TTACGTTCACGTCTCT-1	Normal
TTACGTTGTCAACCTA-1	Normal
TTACGTTGTCCACATA-1	Normal
TTACTGTAGATTACCC-1	Normal
TTACTGTCATGTTACG-1	VEGFA_GBM
TTAGGCAAGTAGCAAT-1	VEGFA_GBM
TTAGGCACAGTGAGCA-1	Normal
TTAGGCAGTGAACTAA-1	MEGF11_GBM
TTAGGCATCGAGAATA-1	Normal
TTAGGGTAGTAGGAAG-1	Normal
TTAGGGTCAGCTCCTT-1	Normal
TTAGGGTCATTCTCTA-1	Normal
TTAGGGTGTAAGATCA-1	Normal
TTAGGGTGTACTGACT-1	Normal
TTAGGGTTCGAGAACG-1	VEGFA_GBM
TTAGTCTAGAGAGCGG-1	Normal
TTAGTCTAGCGATTCT-1	Normal
TTAGTCTCACCGTCTT-1	VEGFA_GBM
TTAGTCTCAGATTTCG-1	Normal
TTAGTCTCAGGTTACT-1	Normal
TTAGTCTCAGGTTTAC-1	VEGFA_GBM
TTAGTCTCATATTCGG-1	MEGF11_GBM
TTAGTCTGTTCTGACA-1	GFAP_GBM
TTAGTCTTCACCTCTG-1	Normal
TTATTGCCAACGTATC-1	GFAP_GBM
TTCAATCAGCTTCATG-1	MEGF11_GBM
TTCAATCTCGCCTTTG-1	Normal
TTCACCGAGAGATGCC-1	Normal
TTCACCGCAATCTCGA-1	GFAP_GBM
TTCACCGCAGGCTATT-1	MEGF11_GBM
TTCACCGGTACGGCAA-1	MEGF11_GBM
TTCACCGGTTCGGTCG-1	VEGFA_GBM
TTCACCGTCCGCTAGG-1	MEGF11_GBM
TTCACGCAGGCACTAG-1	VEGFA_GBM
TTCACGCAGGCAGGGA-1	Normal
TTCACGCGTACCTGTA-1	Normal
TTCACGCGTGCCTAAT-1	Normal
TTCACGCGTGGCCACT-1	GFAP_GBM
TTCACGCTCCGTGTCT-1	Normal
TTCATGTCACGAGAAC-1	Normal
TTCATGTCATGAAGCG-1	Normal
TTCATGTGTAACGGTG-1	Normal
TTCATTGAGCTAGCCC-1	MEGF11_GBM
TTCATTGCACAAGCCC-1	VEGFA_GBM
TTCATTGCACTAGGTT-1	GFAP_GBM
TTCATTGGTAAGGCCA-1	Normal
TTCCAATGTACCAATC-1	MEGF11_GBM
TTCCAATGTAGCCAGA-1	MEGF11_GBM
TTCCAATGTTCCTTGC-1	Clone_2nd
TTCCAATTCAAAGCCT-1	MEGF11_GBM
TTCCAATTCACTGAAC-1	VEGFA_GBM
TTCCAATTCCTCACTG-1	GFAP_GBM
TTCCACGCATGCGTGC-1	MEGF11_GBM
TTCCACGTCAGCTAGT-1	MEGF11_GBM
TTCCACGTCCATTCGC-1	Normal
TTCCACGTCTCGCAGG-1	Normal
TTCCACGTCTGTCCGT-1	VEGFA_GBM
TTCCGGTAGGTAAAGG-1	VEGFA_GBM
TTCCGGTGTCCACATA-1	MEGF11_GBM
TTCCGGTGTTTCCCAC-1	MEGF11_GBM
TTCCGGTTCGACGACC-1	Normal
TTCCGGTTCGCAGTCG-1	Clone_2nd
TTCCGTGAGACTCAAA-1	Normal
TTCCGTGCAGCGAACA-1	GFAP_GBM
TTCCGTGGTAAGATTG-1	Normal
TTCCGTGGTCTGTGGC-1	Normal
TTCCGTGGTTACGTAC-1	Normal
TTCCGTGTCCAGTGTA-1	Normal
TTCCGTGTCCGACAGC-1	Normal
TTCCGTGTCCTCTGCA-1	Normal
TTCCTAAAGCTATCCA-1	Normal
TTCCTAAAGTCCCTAA-1	MEGF11_GBM
TTCCTAACAAATCAGA-1	MEGF11_GBM
TTCCTAAGTACTCGTA-1	Clone_2nd
TTCCTAATCTTCCCAG-1	Normal
TTCCTCTCAAGTGATA-1	MEGF11_GBM
TTCCTCTGTAGCTGCC-1	Normal
TTCCTTCAGAATCCCT-1	VEGFA_GBM
TTCCTTCAGAGTATAC-1	Normal
TTCCTTCCACAAGTGG-1	MEGF11_GBM
TTCCTTCGTGCTCTCT-1	Normal
TTCCTTCTCATGTCAG-1	Clone_2nd
TTCGATTGTGTAGTGG-1	MEGF11_GBM
TTCGATTTCTCCGCAT-1	Normal
TTCGCTGGTGCGTGCT-1	MEGF11_GBM
TTCGCTGGTTCTCTCG-1	Normal
TTCGCTGTCCGCAACG-1	Normal
TTCGGTCCACTCCGAG-1	GFAP_GBM
TTCGGTCCAGAGTTGG-1	Normal
TTCGGTCCAGGTGGAT-1	MEGF11_GBM
TTCGGTCCATTGACCA-1	MEGF11_GBM
TTCGGTCTCAACACCA-1	Normal
TTCGGTCTCTGACCCT-1	Normal
TTCTAACAGCTGGAGT-1	Normal
TTCTAACCACTATCGA-1	Normal
TTCTAACCACTTGGCG-1	Normal
TTCTAACCATCCGTTC-1	MEGF11_GBM
TTCTAACTCGGTGCAC-1	Normal
TTCTAGTAGATGAATC-1	GFAP_GBM
TTCTAGTAGCTCTGTA-1	Normal
TTCTAGTTCACGATCA-1	VEGFA_GBM
TTCTAGTTCCTTCTGG-1	Normal
TTCTCTCCACCAGACC-1	Normal
TTCTCTCCATAGGCGA-1	Normal
TTCTCTCGTGTGGTCC-1	MEGF11_GBM
TTCTGTACAAAGCACG-1	Normal
TTCTGTATCATCCCGT-1	MEGF11_GBM
TTCTTCCAGGTTCATC-1	MEGF11_GBM
TTCTTCCAGTCTTCCC-1	VEGFA_GBM
TTCTTCCGTCCGACGT-1	Normal
TTCTTCCGTTGTAAAG-1	Normal
TTCTTCCTCCGATGCG-1	Normal
TTCTTCCTCCGCTAGG-1	Normal
TTCTTCCTCCGTACGG-1	VEGFA_GBM
TTCTTCCTCGTAGTCA-1	Normal
TTCTTGAAGAGATGCC-1	Normal
TTCTTGAAGGCGTTAG-1	Normal
TTCTTGACATGGCCAC-1	Normal
TTCTTGATCATTCATC-1	GFAP_GBM
TTCTTGATCGAGAAGC-1	Normal
TTCTTGATCTAGGCCG-1	Normal
TTGAACGCACTTACAG-1	Normal
TTGAACGGTAGCGCCT-1	Normal
TTGAACGGTTCCCAAA-1	VEGFA_GBM
TTGACCCAGACTCCGC-1	GFAP_GBM
TTGACCCAGCGGTATG-1	GFAP_GBM
TTGACCCAGTCTAACC-1	Normal
TTGACCCGTTGTGTTG-1	MEGF11_GBM
TTGACCCTCATCTATC-1	Normal
TTGACCCTCTAGCATG-1	Normal
TTGAGTGAGGCCCAAA-1	VEGFA_GBM
TTGAGTGAGGGCGAGA-1	VEGFA_GBM
TTGAGTGCACTACCCT-1	Normal
TTGAGTGGTGCGAGTA-1	Normal
TTGAGTGGTGCTGTCG-1	GFAP_GBM
TTGAGTGGTTCAAAGA-1	Normal
TTGAGTGTCGCGTGAC-1	Normal
TTGAGTGTCGGACGTC-1	MEGF11_GBM
TTGAGTGTCTGTGCGG-1	Normal
TTGATGGAGCAAGCCA-1	Normal
TTGATGGCATATTCGG-1	VEGFA_GBM
TTGATGGTCAAAGGAT-1	Normal
TTGCATTAGGCACAAC-1	Normal
TTGCATTCATTGTCGA-1	Normal
TTGCATTGTCGCGTCA-1	Normal
TTGCATTGTGCAGTGA-1	GFAP_GBM
TTGCATTGTTCGGTAT-1	Normal
TTGCATTTCCATAGGT-1	Normal
TTGCATTTCCTATGGA-1	MEGF11_GBM
TTGCATTTCGCTTTAT-1	Normal
TTGCATTTCTGTTGGA-1	GFAP_GBM
TTGCCTGAGGTATCTC-1	Normal
TTGCGTCAGACCAGAC-1	MEGF11_GBM
TTGCGTCCAAAGCTAA-1	Normal
TTGCGTCGTTACACAC-1	Normal
TTGCTGCAGAAGCGCT-1	Normal
TTGCTGCCAGCAGTGA-1	Normal
TTGCTGCCAGTAACGG-1	MEGF11_GBM
TTGCTGCCATGCGTGC-1	GFAP_GBM
TTGGATGAGGCTATCT-1	MEGF11_GBM
TTGGATGAGTAGACAT-1	Normal
TTGGATGGTAGAGTTA-1	GFAP_GBM
TTGGATGGTCCAACGC-1	Normal
TTGGATGGTGGTCCGT-1	MEGF11_GBM
TTGGGATAGGCTTTCA-1	MEGF11_GBM
TTGGGATGTCTGCGCA-1	Normal
TTGGGATTCTTGTGCC-1	GFAP_GBM
TTGGGCGCAGAACATA-1	Normal
TTGGGCGCATATAGCC-1	MEGF11_GBM
TTGGGCGGTAATGCGG-1	MEGF11_GBM
TTGGGCGGTCCAGGTC-1	GFAP_GBM
TTGGGCGTCATTTGGG-1	Normal
TTGGGCGTCCACCTCA-1	MEGF11_GBM
TTGGGTACATGGGAAC-1	MEGF11_GBM
TTGGGTACATTCTCCG-1	GFAP_GBM
TTGGGTAGTACACTCA-1	Normal
TTGGTTTAGTGAGCCA-1	Normal
TTGGTTTCATACCATG-1	Normal
TTGGTTTCATGGCTAT-1	Normal
TTGGTTTGTAGTATAG-1	MEGF11_GBM
TTGGTTTGTTCGTTCC-1	Normal
TTGGTTTTCCACACCT-1	Normal
TTGGTTTTCCCTCTTT-1	Normal
TTGTGGAAGCCAAGCA-1	GFAP_GBM
TTGTGGAAGGAGAGGC-1	Normal
TTGTGGACATGCGGTC-1	Normal
TTGTGGAGTAAGCAAT-1	GFAP_GBM
TTGTGTTCAGTTCTAG-1	MEGF11_GBM
TTGTGTTTCACGATCA-1	GFAP_GBM
TTGTGTTTCACTTCTA-1	Normal
TTGTGTTTCGATCCCT-1	Normal
TTGTGTTTCGTTCTCG-1	Normal
TTGTTCAAGAAGTATC-1	Normal
TTGTTCAAGGTACATA-1	VEGFA_GBM
TTGTTCAAGTGGATAT-1	Normal
TTGTTCAGTAACGTTC-1	GFAP_GBM
TTGTTCATCCATACTT-1	Normal
TTGTTGTTCTGCATAG-1	VEGFA_GBM
TTGTTTGAGCGTGAGT-1	Normal
TTGTTTGAGGCCGCTT-1	Normal
TTGTTTGAGTGCACAG-1	Normal
TTGTTTGCATAATGCC-1	Normal
TTGTTTGGTCAACACT-1	GFAP_GBM
TTGTTTGGTTTCGTAG-1	GFAP_GBM
TTTACCATCCTTATCA-1	Normal
TTTACGTAGCGTTACT-1	MEGF11_GBM
TTTACGTCACAGTATC-1	MEGF11_GBM
TTTACGTCACGGTGAA-1	MEGF11_GBM
TTTACGTCACGTCGGT-1	Normal
TTTACGTCAGAGCCCT-1	Normal
TTTACGTGTACGCTAT-1	VEGFA_GBM
TTTACGTGTCCTCCAT-1	MEGF11_GBM
TTTACGTTCCATTTCA-1	Normal
TTTACGTTCGAGATGG-1	GFAP_GBM
TTTACTGAGATTGATG-1	Normal
TTTACTGAGCCTGACC-1	Normal
TTTACTGTCTACGCAA-1	Normal
TTTAGTCAGCTTCTAG-1	Normal
TTTAGTCCACTCCCTA-1	Normal
TTTAGTCCATGGAATA-1	GFAP_GBM
TTTAGTCGTGTGAATA-1	MEGF11_GBM
TTTATGCAGCCGTAAG-1	Normal
TTTATGCCAACCCTAA-1	MEGF11_GBM
TTTATGCGTATCCTTT-1	Normal
TTTATGCTCAACCTTT-1	Normal
TTTATGCTCTCGTTTA-1	MEGF11_GBM
TTTCACACAAATCGTC-1	MEGF11_GBM
TTTCAGTCACTCGATA-1	MEGF11_GBM
TTTCAGTCATAGGTAA-1	Normal
TTTCATGAGGTAACTA-1	VEGFA_GBM
TTTCATGAGTAACAGT-1	MEGF11_GBM
TTTCATGCAGTGACCC-1	Normal
TTTCATGGTCACCACG-1	Normal
TTTCATGGTGGTCTTA-1	Normal
TTTCATGTCGGACGTC-1	Normal
TTTCATGTCTCCCTAG-1	MEGF11_GBM
TTTCATGTCTCGAGTA-1	MEGF11_GBM
TTTCCTCAGCACCAGA-1	Normal
TTTCCTCGTACTTGTG-1	MEGF11_GBM
TTTCCTCGTCACTCAA-1	GFAP_GBM
TTTCCTCGTTTCTTAC-1	GFAP_GBM
TTTCCTCTCCGTGACG-1	Normal
TTTCCTCTCTTGGATG-1	Normal
TTTCGATAGGGCAATC-1	MEGF11_GBM
TTTCGATCAAGAGCTG-1	Normal
TTTCGATTCACCCTGT-1	Normal
TTTGACTGTACCTTCC-1	Normal
TTTGACTTCGTTGTAG-1	Normal
TTTGATCAGGCTCCCA-1	Normal
TTTGATCGTGGAAATT-1	MEGF11_GBM
TTTGATCTCCGTGTAA-1	GFAP_GBM
TTTGGAGAGGACAGTC-1	Normal
TTTGGAGAGGATGGCT-1	GFAP_GBM
TTTGGAGAGGTTCACT-1	GFAP_GBM
TTTGGAGCAGTGGGTA-1	VEGFA_GBM
TTTGGAGTCCATAGAC-1	Normal
TTTGGAGTCGATTCCC-1	Normal
TTTGGTTAGCCAAGCA-1	Normal
TTTGGTTAGTAGTCTC-1	Normal
TTTGGTTCAAGGCTTT-1	Normal
TTTGGTTGTCTTGTCC-1	Normal
TTTGGTTTCACTACTT-1	GFAP_GBM
TTTGTTGAGGCTTAGG-1	MEGF11_GBM
TTTGTTGCAGCATCTA-1	MEGF11_GBM
TTTGTTGCATACCAGT-1	GFAP_GBM
TTTGTTGGTGTAACGG-1	MEGF11_GBM
TTTGTTGTCCACGGAC-1	Normal
TTTGTTGTCCGACATA-1	Normal
