AAACCTGCACCTTGTC-1	T
AAACGGGAGTCCTCCT-1	N
AAACGGGTCCAGAGGA-1	T
AAAGATGCAGTTTACG-1	T
AAAGCAACAGGAATGC-1	T
AAAGCAATCGGAATCT-1	T
AAAGTAGAGTGTACTC-1	N
AAAGTAGCAGCCTATA-1	T
AAAGTAGGTACAGTTC-1	N
AAAGTAGTCGCATGAT-1	T
AAAGTAGTCTATCCCG-1	T
AAATGCCAGTACGTTC-1	T
AAATGCCCATTGGTAC-1	T
AAATGCCGTTGGTTTG-1	T
AACACGTTCTTAGAGC-1	T
AACCATGAGATGTCGG-1	T
AACCATGGTGTGGTTT-1	T
AACCATGTCACCACCT-1	T
AACCATGTCACCAGGC-1	T
AACCATGTCGTATCAG-1	N
AACCATGTCGTTTATC-1	T
AACCGCGCACCTATCC-1	T
AACCGCGGTGTCAATC-1	T
AACCGCGTCAAAGACA-1	T
AACGTTGTCGACCAGC-1	T
AACTCAGAGCTAGGCA-1	N
AACTCAGCAAGAAAGG-1	T
AACTCAGTCAGGATCT-1	T
AACTCAGTCCCAAGAT-1	T
AACTCCCCAAGCCCAC-1	T
AACTCCCCAGCAGTTT-1	T
AACTCCCGTAGGAGTC-1	T
AACTCCCGTGCACCAC-1	T
AACTCCCTCTCTAGGA-1	N
AACTCTTCAATAACGA-1	N
AACTCTTTCTTGTCAT-1	T
AACTGGTGTTTCCACC-1	N
AAGACCTCAGCTGCTG-1	T
AAGCCGCAGAAACCGC-1	N
AAGGAGCAGACAAGCC-1	T
AAGGAGCTCGAACTGT-1	T
AAGGCAGGTCACCTAA-1	T
AAGGCAGTCGCATGGC-1	N
AAGGTTCGTAGCGCTC-1	N
AAGGTTCGTTTAAGCC-1	T
AAGGTTCTCGAGCCCA-1	T
AAGTCTGCAGCTATTG-1	N
AAGTCTGCATCCGTGG-1	T
AATCCAGGTGCAACGA-1	T
AATCGGTTCGCATGGC-1	T
AATCGGTTCTCTAGGA-1	T
ACACCAAAGCACGCCT-1	T
ACACCCTAGAGCTTCT-1	T
ACACCCTGTAGCTAAA-1	N
ACACCGGCATGGTCTA-1	T
ACAGCTACACAGACTT-1	N
ACAGCTATCCAAGCCG-1	T
ACATCAGCAGTGACAG-1	T
ACCAGTAAGTTCGATC-1	T
ACCAGTACAGTTAACC-1	T
ACCAGTATCGTAGGAG-1	T
ACCCACTCATCGATGT-1	N
ACCCACTCATTGTGCA-1	T
ACCGTAAAGTATCTCG-1	T
ACCGTAACATGGAATA-1	T
ACCTTTACATCCGTGG-1	T
ACCTTTATCACCTTAT-1	N
ACGAGCCAGGCAAAGA-1	T
ACGAGCCTCCCTCAGT-1	T
ACGAGGACATGGTCTA-1	T
ACGATACGTCTAGTCA-1	T
ACGATACGTGACAAAT-1	N
ACGATACGTTGTTTGG-1	T
ACGATACTCCGTAGTA-1	T
ACGATGTTCTGTCAAG-1	N
ACGCAGCAGGCAATTA-1	T
ACGCAGCCAACACCCG-1	T
ACGCAGCCAGATAATG-1	N
ACGCAGCGTTCAACCA-1	T
ACGCCAGTCACAGTAC-1	T
ACGGAGAAGCAGGTCA-1	N
ACGGAGACATCCGTGG-1	T
ACGGCCAAGGGATGGG-1	N
ACGGCCACAAAGGAAG-1	T
ACGGCCACACTTAACG-1	T
ACGGCCAGTCAATACC-1	T
ACGGCCAGTTTGCATG-1	T
ACGGCCATCAGATAAG-1	T
ACGGCCATCCCTAACC-1	T
ACGGGCTAGCTGGAAC-1	N
ACGGGCTGTATAGGTA-1	T
ACGGGTCCACCAGATT-1	T
ACGGGTCCATACGCCG-1	T
ACGGGTCGTGTGAAAT-1	T
ACGTCAAAGACCTAGG-1	T
ACGTCAAGTGCAACGA-1	T
ACTATCTCAGTTTACG-1	T
ACTATCTGTAAGTGGC-1	T
ACTGAACAGATGCCTT-1	T
ACTGAACGTTCGTGAT-1	T
ACTGAACTCTTTAGTC-1	T
ACTGAGTAGCGGCTTC-1	T
ACTGAGTCATCGGAAG-1	N
ACTGAGTTCCCGACTT-1	N
ACTGATGGTCTCCACT-1	N
ACTGATGGTGAGTGAC-1	T
ACTGCTCAGGGCACTA-1	T
ACTGCTCCATACTACG-1	N
ACTGTCCGTAGAAAGG-1	T
ACTGTCCGTCATGCAT-1	T
ACTGTCCTCAAACGGG-1	T
ACTTACTAGTTTGCGT-1	N
ACTTACTCACGAAGCA-1	T
ACTTGTTAGTTCGCAT-1	N
ACTTGTTTCAGTACGT-1	T
ACTTTCACACAACTGT-1	T
ACTTTCACATGTCTCC-1	N
ACTTTCAGTGCTGTAT-1	T
ACTTTCATCCAGTAGT-1	T
AGAATAGAGAAGGCCT-1	T
AGAATAGAGAAGGGTA-1	T
AGAATAGTCAATCTCT-1	N
AGACGTTAGCACGCCT-1	T
AGACGTTAGCGTTGCC-1	T
AGACGTTGTAAAGTCA-1	N
AGAGCGACATTTGCCC-1	T
AGAGCTTTCGAACTGT-1	N
AGAGTGGTCACTCTTA-1	T
AGATCTGAGATGTGTA-1	T
AGATCTGCACAGCCCA-1	T
AGATCTGGTCCGAAGA-1	T
AGATCTGGTCTAGCCG-1	T
AGATTGCCACCACCAG-1	T
AGATTGCTCGTATCAG-1	N
AGATTGCTCTTGAGAC-1	T
AGCAGCCGTCCGACGT-1	N
AGCAGCCTCAGCTCTC-1	N
AGCAGCCTCGACAGCC-1	N
AGCAGCCTCTCCGGTT-1	T
AGCATACGTACCGAGA-1	N
AGCATACTCGTCACGG-1	T
AGCCTAAAGCTGCAAG-1	T
AGCCTAACAGCTGCTG-1	N
AGCCTAAGTCGCTTTC-1	T
AGCGGTCAGCTCCTCT-1	T
AGCGGTCTCATCTGTT-1	T
AGCGGTCTCGATGAGG-1	T
AGCGTATAGGACAGCT-1	T
AGCGTATGTTCAGACT-1	N
AGCGTCGAGGGATGGG-1	T
AGCGTCGAGTGATCGG-1	T
AGCGTCGTCGAGCCCA-1	T
AGCTCCTCACATCCGG-1	T
AGCTCTCCAGCCACCA-1	T
AGCTCTCTCAGCGATT-1	N
AGCTTGAGTTACGGAG-1	T
AGGCCACCAGTAAGCG-1	T
AGGCCGTAGTTCCACA-1	N
AGGCCGTTCCGTACAA-1	T
AGGGAGTTCACGAAGG-1	T
AGGGATGAGAAGATTC-1	T
AGGGATGCAATCCGAT-1	T
AGGGATGTCGCTTAGA-1	T
AGGTCATAGACACTAA-1	T
AGGTCATAGCAGACTG-1	T
AGGTCATAGCGTGAGT-1	T
AGGTCATGTATAAACG-1	T
AGGTCATGTGCTAGCC-1	T
AGGTCATTCTCTAAGG-1	T
AGGTCCGTCTGTCTCG-1	T
AGTCTTTAGCGCTTAT-1	N
AGTGAGGAGGTGCACA-1	N
AGTGGGAGTAGAGCTG-1	N
AGTGGGAGTCAATGTC-1	N
AGTGGGAGTCGAAAGC-1	N
AGTGGGAGTGGTCCGT-1	T
AGTGTCAAGACTAGGC-1	T
AGTGTCATCTGCTGTC-1	T
AGTTGGTAGACCACGA-1	N
AGTTGGTCAAGGTTTC-1	T
AGTTGGTCAGGACCCT-1	N
AGTTGGTGTCTGATTG-1	T
AGTTGGTTCCCTAATT-1	T
AGTTGGTTCGCCATAA-1	T
ATAACGCCACGTCAGC-1	T
ATAACGCCAGTGAGTG-1	T
ATAACGCGTGTGGTTT-1	N
ATAACGCTCCACTCCA-1	T
ATAACGCTCCGCATAA-1	N
ATAAGAGAGATATGGT-1	T
ATAAGAGCATGTAGTC-1	T
ATAAGAGTCCCTAATT-1	T
ATAAGAGTCTTGAGAC-1	T
ATAGACCAGCAGGTCA-1	T
ATAGACCCATCCTTGC-1	N
ATCATCTAGCTTATCG-1	T
ATCATCTGTTCCCGAG-1	T
ATCATCTTCGAGAACG-1	T
ATCATCTTCTGTGCAA-1	N
ATCATGGCACCACCAG-1	T
ATCATGGCACGACGAA-1	T
ATCCACCAGCGTAATA-1	T
ATCCACCAGGTGATAT-1	N
ATCCACCTCGAGAGCA-1	T
ATCGAGTAGGAACTGC-1	T
ATCGAGTAGTGTCCCG-1	T
ATCGAGTCAAGAGGCT-1	T
ATCTACTAGCACCGTC-1	T
ATCTACTAGCGCCTTG-1	N
ATCTACTGTGCTGTAT-1	N
ATCTGCCGTGGCGAAT-1	T
ATGAGGGAGTGTTTGC-1	T
ATGAGGGGTATGAAAC-1	N
ATGAGGGTCACTTATC-1	T
ATGAGGGTCTTAACCT-1	T
ATGCGATGTAGAGGAA-1	T
ATGCGATGTTCCGTCT-1	N
ATGGGAGGTAAGTGTA-1	T
ATGTGTGAGCGTTGCC-1	T
ATGTGTGAGGCGTACA-1	N
ATTATCCCAGCCAGAA-1	T
ATTATCCGTCTGCAAT-1	T
ATTCTACAGTGTCTCA-1	T
ATTCTACGTTTACTCT-1	T
ATTGGACGTCGGCTCA-1	T
ATTGGACGTTACGCGC-1	T
ATTGGTGCATGGGACA-1	T
ATTGGTGTCAGTCCCT-1	T
ATTTCTGAGGACCACA-1	T
ATTTCTGCAAAGCAAT-1	T
ATTTCTGGTCCATCCT-1	T
CAACCAACAAACTGTC-1	T
CAACCAACAATTCCTT-1	T
CAACCTCCATCACGTA-1	T
CAACCTCGTTGCTCCT-1	T
CAACCTCTCCTAGGGC-1	T
CAACTAGAGGTACTCT-1	T
CAAGAAAAGACAAAGG-1	T
CAAGAAACAAACTGTC-1	T
CAAGAAATCATAGCAC-1	T
CAAGATCAGCTCTCGG-1	N
CAAGATCAGGATCGCA-1	T
CAAGATCAGTCGTACT-1	N
CAAGATCCACCAGATT-1	N
CAAGATCCATGTCCTC-1	T
CAAGATCGTCGGCATC-1	T
CAAGATCTCGATCCCT-1	T
CAAGATCTCTAACTGG-1	T
CAAGATCTCTGTACGA-1	N
CAAGGCCGTGCGATAG-1	N
CAAGGCCTCGGTTAAC-1	T
CAAGTTGAGCTCCTCT-1	N
CACAAACCAAAGCAAT-1	T
CACACAACAAGTTCTG-1	T
CACACAACATTTGCTT-1	T
CACACAATCAGTCCCT-1	N
CACACAATCGTGGACC-1	T
CACACCTCAAGAAGAG-1	T
CACACCTTCTTACCGC-1	T
CACACTCAGGGCTTCC-1	N
CACACTCAGTCCTCCT-1	T
CACACTCCAACTGCTA-1	N
CACAGGCAGTACACCT-1	T
CACAGTAAGGTAAACT-1	N
CACAGTACAAACCCAT-1	T
CACAGTAGTAGAGTGC-1	T
CACAGTATCGGTTCGG-1	T
CACATAGGTGGTTTCA-1	N
CACCACTAGACTGTAA-1	T
CACCACTAGCTAAACA-1	N
CACCACTTCACAACGT-1	T
CACCACTTCCTCATTA-1	T
CACCAGGGTCGCATCG-1	T
CACCTTGCATTACCTT-1	T
CACCTTGGTACAGCAG-1	T
CACCTTGGTCTTCTCG-1	T
CACTCCACATGATCCA-1	T
CAGAATCAGGACAGAA-1	N
CAGAATCAGGATGCGT-1	T
CAGAATCTCCATGAAC-1	T
CAGAGAGCAGTATAAG-1	N
CAGCAGCAGGACGAAA-1	N
CAGCAGCCAATCTACG-1	N
CAGCAGCTCCCGACTT-1	T
CAGCCGAGTCTAGTCA-1	T
CAGCGACAGCATCATC-1	T
CAGCGACCACTCGACG-1	T
CAGCGACCATGCGCAC-1	N
CAGCTAAAGATGGGTC-1	T
CAGCTAAAGTACATGA-1	T
CAGCTAACAGGTGGAT-1	T
CAGCTAACATGCAATC-1	T
CAGCTAAGTAGTAGTA-1	T
CAGCTAAGTGCTAGCC-1	N
CAGCTAATCCACGACG-1	T
CAGCTGGAGAGGGATA-1	T
CAGCTGGAGGAACTGC-1	N
CAGCTGGGTACCGTAT-1	N
CAGGTGCAGCAGCCTC-1	N
CAGGTGCAGCGCCTCA-1	T
CAGGTGCAGTGACTCT-1	T
CATATGGAGACCACGA-1	T
CATATGGAGCCTTGAT-1	T
CATATGGAGGTGATAT-1	T
CATATGGCAAAGTCAA-1	T
CATATGGCACGAAACG-1	T
CATATGGGTCAAAGAT-1	N
CATATGGTCTCTTGAT-1	N
CATATTCGTACCGAGA-1	T
CATCAAGAGAGTGAGA-1	N
CATCAAGAGTCTCCTC-1	T
CATCAAGAGTCTTGCA-1	T
CATCAAGCAATCGGTT-1	T
CATCAAGGTGTGTGCC-1	N
CATCAGATCCTCGCAT-1	N
CATCCACCAAGCGCTC-1	T
CATCCACCAGCCTATA-1	T
CATCCACCAGGCTCAC-1	T
CATCGGGAGAATAGGG-1	N
CATCGGGAGCGTCAAG-1	T
CATCGGGAGTACTTGC-1	T
CATCGGGCAATGCCAT-1	T
CATCGGGTCACGGTTA-1	T
CATCGGGTCATACGGT-1	T
CATCGGGTCGGTGTTA-1	T
CATCGGGTCTCCTATA-1	T
CATGACAGTTGTACAC-1	T
CATGCCTGTCGAGTTT-1	N
CATGGCGTCTTTCCTC-1	T
CATTCGCTCCAGGGCT-1	T
CCAATCCAGGTGATAT-1	T
CCAATCCAGTTGTAGA-1	N
CCAATCCCATAACCTG-1	T
CCAATCCGTATATCCG-1	T
CCAATCCGTCTGCCAG-1	T
CCAATCCGTGTAATGA-1	T
CCACCTAAGGGTTCCC-1	T
CCACCTACAGTCGTGC-1	T
CCACGGAAGGAGTAGA-1	T
CCACGGACACTTAACG-1	T
CCACTACCAGGATTGG-1	T
CCACTACTCTATCCCG-1	T
CCAGCGAAGGCATGGT-1	N
CCAGCGACAGTCACTA-1	N
CCAGCGATCTGCTGCT-1	T
CCATGTCCACCACGTG-1	T
CCATGTCGTTCGTTGA-1	N
CCATTCGAGCTCTCGG-1	T
CCATTCGAGGTGCTTT-1	T
CCATTCGCATAGGATA-1	T
CCATTCGGTTAAAGAC-1	T
CCCAATCAGTGTGGCA-1	T
CCCAATCTCCGTACAA-1	T
CCCAGTTAGCTCCCAG-1	T
CCCAGTTCACCACGTG-1	T
CCCAGTTGTATAGGGC-1	N
CCCATACAGTCGTACT-1	T
CCCATACCATTTGCCC-1	T
CCCATACGTCTGGTCG-1	T
CCCTCCTCACTCTGTC-1	T
CCGGGATGTACTCGCG-1	T
CCGGGATTCCAGGGCT-1	N
CCGGTAGAGCGATAGC-1	N
CCGGTAGGTACCAGTT-1	T
CCGGTAGGTATGAATG-1	N
CCGGTAGGTCATCGGC-1	T
CCGGTAGTCAATCTCT-1	T
CCGGTAGTCCGATATG-1	T
CCGGTAGTCCTGCAGG-1	N
CCGTACTGTTCCGTCT-1	N
CCGTACTGTTCCTCCA-1	N
CCGTGGATCTGCCCTA-1	T
CCGTTCAAGATGTTAG-1	N
CCGTTCATCCCGGATG-1	T
CCGTTCATCCGGCACA-1	N
CCTAAAGAGGTCATCT-1	T
CCTAAAGCAATGCCAT-1	T
CCTAAAGCAATTCCTT-1	T
CCTAAAGCATGGAATA-1	T
CCTAAAGGTGATGTGG-1	N
CCTAAAGTCCGAACGC-1	T
CCTACACCAGATAATG-1	T
CCTACACGTAAGGATT-1	N
CCTACCATCTTCCTTC-1	N
CCTAGCTAGCCACGCT-1	T
CCTAGCTGTCACTGGC-1	T
CCTAGCTGTGTGACGA-1	N
CCTATTAAGTGGAGAA-1	T
CCTCAGTTCGGAATCT-1	N
CCTCTGATCATGCAAC-1	N
CCTTACGCACGAAACG-1	T
CCTTACGCACGGCTAC-1	T
CCTTACGCATAGAAAC-1	T
CCTTACGCATTCTCAT-1	T
CCTTCCCAGTTACCCA-1	T
CCTTCCCGTTGCGCAC-1	T
CCTTCCCGTTTGTTTC-1	T
CCTTCGACAACACGCC-1	T
CCTTCGACACCGGAAA-1	T
CCTTTCTCATCGGGTC-1	T
CCTTTCTGTAACGTTC-1	T
CGAATGTGTCTTCTCG-1	T
CGAATGTGTGACGCCT-1	T
CGAATGTGTGCTGTAT-1	N
CGACCTTCACCCTATC-1	T
CGACCTTCACCTATCC-1	N
CGACTTCTCTACCAGA-1	T
CGAGAAGAGAACTCGG-1	T
CGAGAAGAGCGCTCCA-1	T
CGAGCACCACCACCAG-1	N
CGAGCACTCAACTCTT-1	T
CGAGCCACACATGGGA-1	N
CGAGCCATCCCAAGTA-1	T
CGAGCCATCTTGCATT-1	T
CGATCGGCACGGTGTC-1	T
CGATCGGCATCTACGA-1	T
CGATCGGTCTGCGTAA-1	N
CGATGGCCACCAGTTA-1	T
CGATGTAAGAACTGTA-1	T
CGATGTAGTAAATGTG-1	T
CGATGTATCAGTGTTG-1	T
CGCCAAGAGAGTCGGT-1	T
CGCCAAGCAATCAGAA-1	T
CGCGTTTAGGTGATAT-1	T
CGCGTTTCACCGATAT-1	T
CGCGTTTTCATCGGAT-1	T
CGCTATCAGCTCTCGG-1	T
CGCTATCAGTACATGA-1	N
CGCTATCCAGCTTCGG-1	T
CGCTGGAGTAAATGAC-1	T
CGCTTCAGTGACGCCT-1	T
CGCTTCATCTCTTATG-1	N
CGGACGTTCCACGCAG-1	T
CGGACTGGTTTAGCTG-1	T
CGGACTGTCAGTTTGG-1	T
CGGAGCTCAATCTGCA-1	T
CGGAGTCAGCAACGGT-1	N
CGGAGTCCATGGTCTA-1	T
CGGAGTCTCAGTTGAC-1	T
CGGCTAGGTCCGAATT-1	T
CGGGTCAGTACCGGCT-1	T
CGGGTCATCATTGCGA-1	N
CGGTTAAAGGCAATTA-1	N
CGGTTAAGTTACCGAT-1	T
CGGTTAATCGCCATAA-1	N
CGGTTAATCTAGAGTC-1	T
CGTAGCGAGATGCCAG-1	T
CGTAGCGAGCGTGAAC-1	T
CGTAGCGAGGATTCGG-1	T
CGTAGCGCAAGCCGTC-1	T
CGTAGGCCATGTCCTC-1	T
CGTAGGCTCTGTCTCG-1	N
CGTCACTGTACAGTGG-1	N
CGTCACTGTTAAGGGC-1	T
CGTCACTTCTCCAACC-1	T
CGTCAGGAGCCGGTAA-1	T
CGTCAGGAGGGTGTTG-1	T
CGTCAGGTCAGAGCTT-1	T
CGTCCATCAGCTGCTG-1	N
CGTCCATCATGTCTCC-1	N
CGTCCATTCGTTGACA-1	T
CGTGAGCAGACTTGAA-1	T
CGTGAGCGTCAATGTC-1	N
CGTGAGCGTCCGAACC-1	T
CGTGTAACAAGCTGAG-1	T
CGTGTAACAGCGTAAG-1	T
CGTGTAACAGGCTGAA-1	N
CGTGTAAGTTAAGATG-1	T
CGTGTAATCAGTGTTG-1	N
CGTGTAATCGCCCTTA-1	T
CGTGTCTCATCGGGTC-1	T
CGTTAGAAGACACTAA-1	T
CGTTAGAAGCTGTTCA-1	T
CGTTAGACACCGAAAG-1	T
CGTTAGATCAAACAAG-1	T
CGTTAGATCAGCGACC-1	T
CGTTAGATCGTCCAGG-1	T
CGTTCTGAGTTGTCGT-1	N
CGTTCTGCACGAAGCA-1	T
CGTTCTGGTAAGAGAG-1	T
CGTTGGGAGACCCACC-1	T
CGTTGGGCAGTGGAGT-1	T
CGTTGGGCATGAAGTA-1	T
CTAACTTCATCATCCC-1	T
CTAACTTTCTCCAACC-1	T
CTAAGACAGAAACGAG-1	T
CTAAGACTCCCTAACC-1	T
CTAATGGCATACAGCT-1	N
CTAATGGGTATTAGCC-1	T
CTAATGGGTTCCTCCA-1	T
CTAATGGTCATTGCCC-1	T
CTACACCTCCTATGTT-1	T
CTACATTAGTAGATGT-1	T
CTACCCAGTCTCACCT-1	N
CTACGTCTCAATACCG-1	N
CTAGAGTTCTGCCAGG-1	T
CTAGCCTAGCAATCTC-1	T
CTAGCCTCAAGCCCAC-1	T
CTAGCCTCACCTCGGA-1	T
CTAGTGAAGAGGACGG-1	T
CTAGTGACAACCGCCA-1	N
CTAGTGATCCTCCTAG-1	T
CTCACACGTGTGGTTT-1	T
CTCACACTCAAGATCC-1	T
CTCACACTCACATGCA-1	T
CTCACACTCCTAGTGA-1	T
CTCAGAAAGCGGCTTC-1	N
CTCAGAAAGGGCTTGA-1	T
CTCAGAAGTGTGACGA-1	T
CTCATTACAGGCGATA-1	T
CTCATTAGTCTACCTC-1	T
CTCATTAGTCTAGCCG-1	T
CTCATTATCAGCTTAG-1	T
CTCCTAGAGGCATGGT-1	N
CTCCTAGAGTAGGCCA-1	T
CTCGAAAAGTTAGCGG-1	T
CTCGGAGGTCCGAATT-1	T
CTCGGGATCGTGGTCG-1	N
CTCGGGATCTGAGGGA-1	T
CTCGTACAGAGCAATT-1	T
CTCGTACCAGACGCTC-1	N
CTCGTCAGTCTAAAGA-1	T
CTCTAATAGGATCGCA-1	N
CTCTAATAGTGAATTG-1	T
CTCTAATGTTTAGCTG-1	T
CTCTACGAGTGTTTGC-1	N
CTCTACGCACTTGGAT-1	T
CTCTACGGTGACTACT-1	N
CTCTGGTAGTGCCATT-1	N
CTCTGGTCATTAACCG-1	T
CTCTGGTGTCGGCATC-1	N
CTCTGGTGTTAAGATG-1	T
CTCTGGTTCGTGGACC-1	N
CTGAAACAGAAACCTA-1	N
CTGAAACAGGCATTGG-1	T
CTGAAACGTCCAGTGC-1	T
CTGAAACTCATGTCCC-1	T
CTGAAACTCCTGCCAT-1	T
CTGAAGTGTGAAGGCT-1	N
CTGAAGTTCAACACTG-1	N
CTGAAGTTCCCATTTA-1	T
CTGATAGGTCCGTCAG-1	T
CTGATCCAGCCGATTT-1	T
CTGATCCGTAGTACCT-1	N
CTGCGGAAGAGTCGGT-1	T
CTGCGGATCGGCTACG-1	T
CTGCTGTGTAATCGTC-1	T
CTGCTGTGTAGCACGA-1	T
CTGGTCTTCGCTGATA-1	T
CTGTGCTGTGGGTCAA-1	N
CTGTGCTGTGTGACCC-1	T
CTTAACTAGAGGTTAT-1	T
CTTAACTAGGGTGTTG-1	T
CTTAACTTCAACGAAA-1	T
CTTACCGGTAGCGTAG-1	N
CTTACCGTCCATTCTA-1	T
CTTCTCTCAATCAGAA-1	N
CTTCTCTCAATGAAAC-1	T
CTTCTCTCAATGGAAT-1	T
CTTCTCTGTACGCACC-1	T
CTTCTCTGTGTATGGG-1	T
CTTGGCTAGCGCCTCA-1	T
CTTGGCTCAGTAGAGC-1	T
CTTGGCTGTTGAGTTC-1	T
CTTTGCGTCCGAAGAG-1	N
GAAACTCCACCCAGTG-1	T
GAAACTCGTCTGCCAG-1	T
GAAACTCTCATGCAAC-1	T
GAAATGAAGTACGCCC-1	T
GAACATCCAATGGTCT-1	T
GAACATCGTAATAGCA-1	T
GAACATCGTACCGTTA-1	T
GAACCTAGTCGCATCG-1	T
GAACCTATCAGAGACG-1	T
GAACCTATCGTTTATC-1	T
GAACGGAAGCCTATGT-1	T
GAACGGAAGGAATTAC-1	N
GAACGGAAGTTACCCA-1	N
GAATAAGAGATCCGAG-1	T
GAATAAGGTGAAGGCT-1	N
GAATAAGGTTATGTGC-1	N
GACACGCTCTCGCATC-1	T
GACAGAGAGCAGGCTA-1	T
GACAGAGGTGTCTGAT-1	T
GACAGAGTCAACACGT-1	T
GACCAATAGACTAAGT-1	N
GACCTGGAGGAGTACC-1	T
GACCTGGCACCTCGTT-1	T
GACGCGTGTGACCAAG-1	N
GACGGCTGTTGTTTGG-1	T
GACGGCTTCTACTATC-1	N
GACGTGCAGACGCACA-1	T
GACGTGCCACTACAGT-1	N
GACGTTAGTTACGCGC-1	T
GACGTTATCTGGAGCC-1	N
GACTAACTCCCATTAT-1	T
GACTAACTCGGAATCT-1	T
GACTACAGTCGTCTTC-1	T
GACTACATCATCGATG-1	T
GACTACATCCTTTCTC-1	N
GACTGCGCAATGCCAT-1	T
GAGCAGAAGCCCAGCT-1	T
GAGCAGAAGTGGCACA-1	T
GAGCAGACAATGACCT-1	N
GAGTCCGGTAATCACC-1	T
GAGTCCGGTCTTCAAG-1	T
GAGTCCGGTGGTAACG-1	N
GAGTCCGTCTGACCTC-1	N
GATCAGTGTAGGAGTC-1	T
GATCGATCATTTCACT-1	N
GATCGATGTAGTACCT-1	T
GATCGATTCACCGGGT-1	T
GATCGTAAGTACGACG-1	N
GATCGTAAGTAGTGCG-1	T
GATCGTACACGAAAGC-1	T
GATCGTACAGATCGGA-1	T
GATCGTAGTTCCCGAG-1	T
GATCTAGAGCTGCGAA-1	T
GATCTAGCAGTCAGCC-1	T
GATCTAGGTAGCAAAT-1	T
GATCTAGTCAAACCGT-1	N
GATCTAGTCTATCCCG-1	N
GATGAAATCAACACAC-1	T
GATGAGGCACAACGCC-1	N
GATGAGGTCTCTGTCG-1	T
GATGCTATCATCGGAT-1	T
GATTCAGGTCCATGAT-1	T
GATTCAGGTCTGATTG-1	T
GATTCAGGTTAAGATG-1	N
GATTCAGTCCTATTCA-1	T
GCAAACTAGCGTGAAC-1	N
GCAAACTTCAACACGT-1	T
GCAATCACAACTGCTA-1	T
GCACATAGTAACGCGA-1	T
GCACATAGTTCCGGCA-1	T
GCACTCTTCCATGAGT-1	T
GCACTCTTCCCTAATT-1	N
GCACTCTTCTCGCTTG-1	T
GCAGCCAAGGAGTTTA-1	T
GCAGCCAAGGGCTTGA-1	T
GCAGCCACATCCGGGT-1	N
GCAGCCACATTCTCAT-1	T
GCAGCCATCATCTGTT-1	T
GCAGTTAAGCTAACTC-1	N
GCATACAAGTACGTTC-1	N
GCATACACACATGACT-1	T
GCATACATCCACTCCA-1	N
GCATGATAGAGGACGG-1	T
GCATGATCACACCGAC-1	N
GCATGATGTATGCTTG-1	T
GCATGATGTCGCGAAA-1	T
GCATGATTCCGAAGAG-1	T
GCATGCGAGAGAGCTC-1	T
GCATGCGAGATCCTGT-1	N
GCATGCGAGTTCCACA-1	T
GCATGCGGTGCCTGTG-1	N
GCATGCGGTTTAGGAA-1	N
GCATGTACAATCGAAA-1	T
GCATGTAGTAGCTAAA-1	N
GCATGTAGTGTAATGA-1	T
GCCAAATAGAATGTTG-1	T
GCCAAATCATCCTTGC-1	N
GCCAAATTCCGTCAAA-1	T
GCGAGAACAAGACACG-1	T
GCGAGAACACGTTGGC-1	T
GCGAGAATCATGCAAC-1	T
GCGAGAATCGGTCTAA-1	T
GCGAGAATCGTCACGG-1	T
GCGAGAATCTGCGTAA-1	N
GCGAGAATCTGGTTCC-1	N
GCGCAACAGGCGCTCT-1	N
GCGCAACCACAACGTT-1	T
GCGCAACTCCAAAGTC-1	T
GCGCAGTAGCAGCGTA-1	N
GCGCAGTCATGCAACT-1	N
GCGCAGTGTATCACCA-1	N
GCGCAGTGTGGTAACG-1	T
GCGCAGTTCACAACGT-1	T
GCGCCAACAACTTGAC-1	N
GCGCCAAGTTAAGGGC-1	T
GCGCCAATCAAGAAGT-1	T
GCGCGATAGGGTATCG-1	N
GCGCGATAGTCCGTAT-1	N
GCGCGATCACATAACC-1	T
GCGCGATTCATTGCGA-1	T
GCGCGATTCTGTCTCG-1	N
GCGGGTTAGGATATAC-1	T
GCGGGTTAGGGAAACA-1	T
GCGGGTTGTCAAAGAT-1	T
GCTCCTAAGAGTAATC-1	N
GCTCCTAAGCTCCTCT-1	N
GCTCCTAAGGAGCGAG-1	N
GCTCCTAGTATTCTCT-1	T
GCTCCTATCAGTTAGC-1	T
GCTCTGTAGATCACGG-1	T
GCTCTGTCAAGAGTCG-1	T
GCTCTGTCATTCCTGC-1	T
GCTCTGTTCGATAGAA-1	T
GCTGCAGAGAAGGGTA-1	N
GCTGCAGCAAAGGTGC-1	T
GCTGCAGTCAGTACGT-1	T
GCTGCGAGTCTCTCTG-1	N
GCTGCGATCAGCAACT-1	T
GCTGGGTCACCACGTG-1	T
GCTGGGTCATATACGC-1	T
GCTGGGTGTGCCTTGG-1	N
GCTTCCACAGGTCCAC-1	T
GCTTCCATCGTCCAGG-1	T
GCTTCCATCTTTCCTC-1	T
GCTTGAAGTAGGCATG-1	T
GGAAAGCAGCTAACTC-1	T
GGAACTTAGATCTGAA-1	T
GGAACTTCAACTGCTA-1	T
GGAACTTCAATACGCT-1	T
GGAATAACAGTAAGAT-1	N
GGAATAATCCGTAGTA-1	T
GGACAAGGTAGCGTGA-1	T
GGACAAGGTGGCTCCA-1	T
GGACAGAAGTGAAGAG-1	T
GGACAGATCAAAGTAG-1	T
GGACAGATCACCTCGT-1	T
GGACAGATCAGTGTTG-1	T
GGACAGATCCAAACAC-1	T
GGACATTAGAACTCGG-1	T
GGACATTAGTCATGCT-1	T
GGACATTCAGGGCATA-1	T
GGACATTCATTACCTT-1	T
GGACGTCAGCACAGGT-1	T
GGACGTCCACAGCGTC-1	T
GGACGTCCACCGTTGG-1	N
GGACGTCGTCAACATC-1	T
GGACGTCTCCGTTGCT-1	T
GGACGTCTCCTAGGGC-1	T
GGAGCAAGTCCTCTTG-1	N
GGAGCAAGTCTAGTCA-1	T
GGAGCAATCCGAGCCA-1	T
GGATGTTGTCATCCCT-1	T
GGATTACAGCAATATG-1	T
GGCAATTAGCTGTCTA-1	T
GGCAATTAGTCCAGGA-1	N
GGCAATTAGTCGTACT-1	T
GGCCGATCAGCGTAAG-1	N
GGCCGATGTGCTTCTC-1	T
GGCGACTAGCTGTTCA-1	N
GGCGACTAGTACGCCC-1	T
GGCGACTAGTCCGTAT-1	T
GGCGACTGTGTAAGTA-1	N
GGCGACTTCTGGGCCA-1	N
GGCGTGTCACCGTTGG-1	T
GGCTCGAAGTAGCGGT-1	T
GGCTCGACAAGTAGTA-1	T
GGCTCGACACTGTGTA-1	T
GGCTCGATCATTATCC-1	T
GGCTCGATCGGTTAAC-1	T
GGCTGGTCACGGTAAG-1	T
GGGAATGTCGCGGATC-1	N
GGGACCTAGCAGCCTC-1	T
GGGACCTCATCCCATC-1	T
GGGACCTTCGACAGCC-1	T
GGGAGATAGATATGGT-1	T
GGGAGATAGCGTTTAC-1	T
GGGAGATCATACGCCG-1	N
GGGATGAAGAGGACGG-1	T
GGGATGACAAGGTTCT-1	T
GGGATGACACCAGGTC-1	T
GGGATGAGTTCTGTTT-1	T
GGGCACTAGCCTATGT-1	T
GGGCATCCATGCTAGT-1	T
GGGCATCCATTCCTCG-1	T
GGGCATCGTCGGCATC-1	T
GGGCATCGTGACGGTA-1	T
GGGTCTGAGGGCTCTC-1	T
GGGTCTGGTAGAGTGC-1	T
GGGTCTGTCATCATTC-1	T
GGGTTGCCAGCTCGCA-1	T
GGGTTGCCAGTCACTA-1	N
GGGTTGCGTACGCTGC-1	T
GGGTTGCGTGGCAAAC-1	T
GGTATTGCATCCTAGA-1	T
GGTATTGTCTGTCTAT-1	T
GGTGAAGGTCCAGTAT-1	T
GGTGCGTGTGGTCCGT-1	N
GGTGTTAGTAACGCGA-1	T
GTAACGTAGTGCTGCC-1	T
GTAACTGCACCAGTTA-1	T
GTAACTGGTACCGTAT-1	T
GTAACTGGTTAAAGTG-1	T
GTAACTGTCGCCTGAG-1	N
GTACGTACAGTAAGCG-1	N
GTACTCCAGGAATGGA-1	T
GTACTCCAGTCGTACT-1	N
GTACTCCCACAGACAG-1	T
GTACTTTCACGGTGTC-1	N
GTACTTTGTGAAAGAG-1	T
GTACTTTGTGTCGCTG-1	N
GTAGGCCAGCGTTCCG-1	N
GTAGGCCCAAGAGGCT-1	T
GTAGGCCGTAATCACC-1	T
GTAGGCCGTCGCCATG-1	T
GTAGTCACACTTAAGC-1	N
GTAGTCACATACAGCT-1	T
GTAGTCACATATGGTC-1	T
GTAGTCAGTTCCACAA-1	T
GTATCTTGTACTTGAC-1	N
GTATCTTTCTTGTACT-1	T
GTATTCTAGTGTACTC-1	T
GTATTCTCAGCCAGAA-1	T
GTCAAGTCACTTCGAA-1	N
GTCAAGTCAGACAAGC-1	T
GTCACGGAGCTGAACG-1	N
GTCACGGAGTTGCAGG-1	T
GTCACGGCACTCTGTC-1	N
GTCACGGGTCAGCTAT-1	T
GTCATTTCACCGAAAG-1	T
GTCCTCAAGACATAAC-1	T
GTCGGGTAGCAGGCTA-1	T
GTCGGGTGTGGGTCAA-1	T
GTCGGGTTCACAACGT-1	T
GTCGGGTTCGACAGCC-1	N
GTCGTAATCCGTAGTA-1	T
GTCGTAATCTAACTTC-1	N
GTCGTAATCTTTACGT-1	T
GTCTCGTGTTCAGACT-1	T
GTCTTCGAGCTCCTTC-1	T
GTGAAGGCAATGAATG-1	T
GTGAAGGGTCGCGAAA-1	T
GTGAAGGTCGTTTGCC-1	T
GTGCAGCAGAGTAATC-1	T
GTGCAGCAGGCATTGG-1	T
GTGCAGCCACCAGCAC-1	N
GTGCAGCGTTGTTTGG-1	T
GTGCAGCTCATGCATG-1	T
GTGCATACACCACCAG-1	T
GTGCATACACGCTTTC-1	N
GTGCTTCCACATCCGG-1	N
GTGCTTCTCAACACTG-1	T
GTGGGTCGTATTCTCT-1	T
GTGTGCGCAAAGTGCG-1	N
GTGTGCGTCGGAATCT-1	T
GTGTTAGCAATCTACG-1	T
GTGTTAGCACCCTATC-1	T
GTGTTAGGTTAGAACA-1	T
GTTAAGCCAATGTAAG-1	T
GTTACAGGTAATCGTC-1	T
GTTACAGGTACGACCC-1	T
GTTACAGGTCAAGCGA-1	T
GTTACAGTCTTGTTTG-1	T
GTTCATTAGAGACTAT-1	T
GTTCATTGTTATCGGT-1	N
GTTCGGGAGATGTCGG-1	T
GTTCGGGCACTTGGAT-1	T
GTTCTCGAGAAACCGC-1	N
GTTCTCGAGAGGTTGC-1	T
GTTCTCGCAATCACAC-1	T
GTTCTCGGTAATAGCA-1	T
GTTCTCGGTCCCTTGT-1	N
GTTTCTATCCGTAGTA-1	N
TAAACCGAGGAACTGC-1	T
TAAACCGCACGGATAG-1	T
TAAACCGCAGATTGCT-1	T
TAAACCGGTATATGAG-1	N
TAAACCGTCAAACCAC-1	T
TAAGAGATCTGAGTGT-1	T
TAAGCGTAGCCCAGCT-1	T
TAAGCGTCAGGCAGTA-1	T
TAAGCGTGTCTAACGT-1	T
TAAGTGCAGAATAGGG-1	T
TAAGTGCCAATCACAC-1	T
TACACGAAGTGAATTG-1	T
TACACGAAGTTAACGA-1	T
TACACGACACAAGCCC-1	T
TACACGAGTCAAAGAT-1	T
TACACGAGTTGAACTC-1	T
TACAGTGCAGACGCTC-1	T
TACAGTGGTAACGTTC-1	T
TACAGTGGTTCTCATT-1	T
TACCTATAGATGAGAG-1	N
TACCTATAGATGGCGT-1	T
TACCTATAGGACACCA-1	N
TACCTATCAGATGGGT-1	N
TACCTTAGTCAGAAGC-1	N
TACGGATCATTGGGCC-1	N
TACGGGCCACCACCAG-1	T
TACGGGCTCAATCACG-1	N
TACGGTAAGCGTAGTG-1	T
TACGGTATCAGTTAGC-1	T
TACTCGCAGGGTGTTG-1	N
TACTCGCGTTCCAACA-1	T
TACTTACAGACACGAC-1	T
TACTTACCAAGAGTCG-1	T
TACTTACGTTAAGAAC-1	T
TACTTACTCTGACCTC-1	T
TACTTGTAGAGGTAGA-1	T
TACTTGTCATGCCCGA-1	N
TACTTGTGTAGCGTCC-1	T
TACTTGTTCACTGGGC-1	T
TAGACCAAGACAGACC-1	T
TAGACCATCTCTGTCG-1	N
TAGAGCTTCCATGAGT-1	N
TAGCCGGCATAACCTG-1	T
TAGTGGTCAATGTAAG-1	N
TAGTTGGCACCGAAAG-1	N
TATCTCAGTCCTCTTG-1	N
TATGCCCCACCCATGG-1	T
TATTACCAGTACGATA-1	T
TATTACCGTTTAAGCC-1	T
TATTACCTCGATAGAA-1	T
TCAACGAGTTTGGCGC-1	N
TCAACGATCCGCATAA-1	T
TCAATCTAGTGTGGCA-1	T
TCAATCTCACGACTCG-1	T
TCACAAGCAGCTTAAC-1	N
TCACAAGTCGAATCCA-1	N
TCACAAGTCGTGGACC-1	N
TCACGAAAGTTAACGA-1	T
TCACGAACACAGGCCT-1	T
TCACGAAGTTTGTTGG-1	T
TCAGATGAGGTAAACT-1	N
TCAGATGGTTACGCGC-1	T
TCAGATGGTTGATTCG-1	T
TCAGCAAAGGCTATCT-1	T
TCAGCAACAGACGCCT-1	T
TCAGCAAGTACAGCAG-1	T
TCAGCAATCATATCGG-1	T
TCAGCTCCAAGAGGCT-1	T
TCAGCTCTCGTAGGTT-1	T
TCAGGATGTTCCATGA-1	T
TCAGGATTCCCAACGG-1	T
TCAGGTACACGAAGCA-1	T
TCAGGTACACGGTAGA-1	T
TCAGGTATCATACGGT-1	T
TCATTACAGTGCCATT-1	T
TCATTACCACTAAGTC-1	N
TCATTACGTACCAGTT-1	N
TCATTACGTACCTACA-1	N
TCATTACGTACGCACC-1	T
TCATTACTCGAATCCA-1	T
TCATTTGCAATCCGAT-1	N
TCCACACGTACTTCTT-1	T
TCCCGATAGGCTAGCA-1	N
TCCCGATGTCGCGGTT-1	N
TCGAGGCCACATTCGA-1	N
TCGAGGCCATTGGCGC-1	T
TCGCGAGAGAAGGTTT-1	N
TCGCGAGAGACATAAC-1	T
TCGCGAGAGATCGATA-1	T
TCGCGAGCACCTATCC-1	N
TCGCGAGCATGGATGG-1	T
TCGCGAGTCCGCTGTT-1	T
TCGCGTTCACCAGGCT-1	N
TCGCGTTGTGACCAAG-1	T
TCGCGTTTCGAATGCT-1	T
TCGGGACTCACTCCTG-1	T
TCGGTAAAGCAATCTC-1	T
TCGGTAAGTGACGGTA-1	T
TCGGTAAGTTTACTCT-1	T
TCGGTAATCCGCGCAA-1	T
TCGTACCCAAGTCTGT-1	N
TCGTACCGTCGAATCT-1	T
TCGTAGACAACAACCT-1	T
TCGTAGATCGCGTAGC-1	T
TCTATTGCAAACGCGA-1	T
TCTATTGGTGCGAAAC-1	T
TCTATTGTCATGTAGC-1	N
TCTCATATCGGTGTCG-1	T
TCTCTAAAGCGTAATA-1	T
TCTCTAAGTCAATACC-1	N
TCTGAGACAGTACACT-1	N
TCTGAGACATATGCTG-1	N
TCTGAGATCTAACTGG-1	N
TCTGGAACAGACAAGC-1	N
TCTGGAACAGTATGCT-1	N
TCTGGAACATGGTCTA-1	N
TCTGGAAGTCGGATCC-1	N
TCTTCGGGTGATGTGG-1	N
TCTTCGGGTTTGTGTG-1	T
TCTTTCCAGTACGACG-1	T
TCTTTCCAGTGGTCCC-1	T
TCTTTCCTCACCGTAA-1	T
TCTTTCCTCGGCGCTA-1	T
TGAAAGAAGCCACCTG-1	T
TGAAAGATCGAATGCT-1	N
TGACAACCACGCGAAA-1	T
TGACAACCACGGCTAC-1	T
TGACGGCTCCTAGTGA-1	N
TGACGGCTCTTTACAC-1	N
TGACTAGAGGCAGTCA-1	T
TGACTAGCAACACCCG-1	N
TGACTAGCACGTCTCT-1	T
TGACTTTAGATGTTAG-1	N
TGACTTTTCCGCATAA-1	T
TGAGAGGAGCTAACAA-1	N
TGAGAGGAGTATCGAA-1	T
TGAGCCGAGACAAGCC-1	T
TGAGCCGAGCACGCCT-1	T
TGAGGGAAGTTAAGTG-1	T
TGAGGGATCGTCGTTC-1	T
TGATTTCGTAACGTTC-1	T
TGATTTCTCACAGGCC-1	T
TGCACCTAGAGGTACC-1	T
TGCACCTGTCGCGGTT-1	T
TGCACCTTCAACACAC-1	N
TGCACCTTCAACACCA-1	N
TGCCAAAGTTAGAACA-1	T
TGCCCATAGCCTTGAT-1	T
TGCCCATGTACTTGAC-1	T
TGCCCATTCAGAGCTT-1	N
TGCCCTAAGACGACGT-1	T
TGCGCAGAGAGACTTA-1	T
TGCGCAGGTACCATCA-1	N
TGCGCAGGTATATGGA-1	T
TGCGCAGGTCTTCGTC-1	N
TGCGGGTTCATTGCGA-1	T
TGCGTGGAGCGAAGGG-1	T
TGCGTGGCATATGAGA-1	T
TGCGTGGGTACAGACG-1	T
TGCTACCAGATGTCGG-1	T
TGCTACCCACGAGGTA-1	T
TGCTACCTCTTACCTA-1	N
TGCTGCTCAAGCGAGT-1	T
TGCTGCTCACCCATTC-1	T
TGCTGCTGTCTAGAGG-1	T
TGGACGCAGAAGGTGA-1	T
TGGACGCCACCAACCG-1	T
TGGCCAGAGCAGGTCA-1	N
TGGCCAGCAGTATGCT-1	T
TGGCCAGGTCTCATCC-1	T
TGGCCAGTCAAAGTAG-1	N
TGGCCAGTCACAATGC-1	T
TGGCGCAAGAATAGGG-1	T
TGGCGCATCGAGAACG-1	T
TGGCTGGAGCACAGGT-1	T
TGGCTGGTCAGGCCCA-1	T
TGGGCGTAGTATCTCG-1	T
TGGGCGTGTTCCACGG-1	T
TGGGCGTTCAAAGACA-1	T
TGGTTAGGTCGGGTCT-1	T
TGGTTCCCATGCTAGT-1	T
TGGTTCCTCATGGTCA-1	T
TGTATTCCATGATCCA-1	T
TGTATTCTCTGAAAGA-1	T
TGTCCCACATGGTCTA-1	T
TGTGGTAAGAGCCTAG-1	T
TGTGGTAGTGTAAGTA-1	T
TGTGGTATCCATTCTA-1	N
TGTTCCGCACCTCGTT-1	T
TGTTCCGGTATGCTTG-1	N
TTAACTCGTTAAGGGC-1	N
TTAGGACAGCCAGTTT-1	T
TTAGGACAGTGAATTG-1	T
TTAGGACCACAGGCCT-1	T
TTAGGACGTGTATGGG-1	T
TTAGTTCAGATCCCGC-1	T
TTAGTTCAGCGATCCC-1	N
TTATGCTAGATGTCGG-1	N
TTATGCTGTTGATTGC-1	T
TTCGAAGAGTGACTCT-1	N
TTCGAAGCAATGGTCT-1	N
TTCGAAGTCAAACAAG-1	N
TTCGAAGTCACCTCGT-1	T
TTCGAAGTCAGGTAAA-1	T
TTCGAAGTCTTGCCGT-1	N
TTCGGTCAGTGGCACA-1	T
TTCGGTCTCCTGCAGG-1	T
TTCGGTCTCTGGCGAC-1	N
TTCTACAAGATGGGTC-1	T
TTCTACACAATACGCT-1	N
TTCTCAAAGCGTTGCC-1	N
TTCTCAAGTCCGAACC-1	T
TTCTCAATCGCCTGAG-1	N
TTCTCAATCTGATTCT-1	T
TTCTTAGGTTTGGCGC-1	T
TTCTTAGTCATTGCGA-1	T
TTGACTTCATATACCG-1	T
TTGACTTTCTTTAGGG-1	N
TTGCGTCAGAGACTTA-1	T
TTGCGTCAGGTAGCCA-1	N
TTGGAACAGGGCATGT-1	T
TTGGAACAGTAAGTAC-1	T
TTGGAACCACAGTCGC-1	N
TTGGAACCACCGTTGG-1	T
TTGGCAATCAGTTTGG-1	T
TTGGCAATCGTCTGAA-1	N
TTGGCAATCGTTTGCC-1	T
TTGGCAATCTTGTTTG-1	T
TTGTAGGAGAGCCCAA-1	N
TTGTAGGGTCGACTGC-1	N
TTGTAGGTCTTCAACT-1	T
TTTACTGAGGACGAAA-1	N
TTTACTGCATGCTAGT-1	N
TTTACTGGTACTCGCG-1	T
TTTATGCGTAAAGTCA-1	T
TTTATGCTCCTCATTA-1	T
TTTATGCTCTGTTGAG-1	T
TTTCCTCTCGGAAACG-1	T
TTTGCGCCAATCACAC-1	T
TTTGTCATCTTGTATC-1	T
